GGCTTGCCTTTAGTGATTCATTAA -> GCTTGCCTTTAGTGATTCATTAAA
GTGATGCGGTACGGAAATGAGACG -> TGATGCGGTACGGAAATGAGACGC
GTGACAACTTGAAGAGGTCAGTGA -> TGACAACTTGAAGAGGTCAGTGAA
ATTGCAGCCTCTTTTTTTCTGTAT -> TTGCAGCCTCTTTTTTTCTGTATC
GTGCTTATCCACGGACGTGACAAC -> TGCTTATCCACGGACGTGACAACT
GGATTGCCGATATGTTGCATACGA -> GATTGCCGATATGTTGCATACGAA
AAGAATGCCCCGATGTAGCCCTTC -> AGAATGCCCCGATGTAGCCCTTCT
TAGTTCTATTCGACGACTCCTCTG -> AGTTCTATTCGACGACTCCTCTGC
GTTGATTGTAGACGGTTCTGGTGG -> TTGATTGTAGACGGTTCTGGTGGA
GTACTAAGTCCAGCTACGTGGCCG -> TACTAAGTCCAGCTACGTGGCCGG
AGTTGGCATGAAGTTGATCGGTAT -> GTTGGCATGAAGTTGATCGGTATC
AAGACATGATATTGTGCCCGGGGA -> AGACATGATATTGTGCCCGGGGAA
TGATTGTAGACGGTTCTGGTGGAT -> GATTGTAGACGGTTCTGGTGGATG
TTCAAGGCAGATTCCAGCACCTCA -> TCAAGGCAGATTCCAGCACCTCAA
CCCGTAAGCCTGGGGATTGATAAG -> CCGTAAGCCTGGGGATTGATAAGC
GCTCGAATTGTCTGTGCCCACTGC -> CTCGAATTGTCTGTGCCCACTGCC
AAACCAGGTGCGCATAATCCGGCG -> AACCAGGTGCGCATAATCCGGCGC
ATTAAAGAAGACATGATATTGTGC -> TTAAAGAAGACATGATATTGTGCC
CTAATTGCCCCAAAAGATAGAGGT -> TAATTGCCCCAAAAGATAGAGGTA
CCACTGCCAGTGGATCCGCGCGGT -> CACTGCCAGTGGATCCGCGCGGTA
TCAAGGCTCGGTTCGTATGCCTCT -> CAAGGCTCGGTTCGTATGCCTCTT
CGGAAATGAGACGCGATATCGAGC -> GGAAATGAGACGCGATATCGAGCC
TTACAAGCGTGCTTATCCACGGAC -> TACAAGCGTGCTTATCCACGGACG
ATTGTAGACGGTTCTGGTGGATGG -> TTGTAGACGGTTCTGGTGGATGGA
AATAGGTTATCTGGGAGAATCTTC -> ATAGGTTATCTGGGAGAATCTTCC
GTATGCCTCTTGCGCGACGTATTA -> TATGCCTCTTGCGCGACGTATTAA
GACGGTTCTGGTGGATGGAAGCAT -> ACGGTTCTGGTGGATGGAAGCATA
TTGCCGACTTTCCAGGTAAAATGC -> TGCCGACTTTCCAGGTAAAATGCC
TGCGGTACGGAAATGAGACGCGAT -> GCGGTACGGAAATGAGACGCGATA
GATTCCAGCACCTCAATGAAGTGT -> ATTCCAGCACCTCAATGAAGTGTG
GTCTAATTGCCCCAAAAGATAGAG -> TCTAATTGCCCCAAAAGATAGAGG
ATTACAAGCGTGCTTATCCACGGA -> TTACAAGCGTGCTTATCCACGGAC
GGAAGCCAGCCACCCATAACTCTA -> GAAGCCAGCCACCCATAACTCTAA
CCTGTTGATTGTAGACGGTTCTGG -> CTGTTGATTGTAGACGGTTCTGGT
CGATATGCACCTCGTCACAATCGA -> GATATGCACCTCGTCACAATCGAA
GGATACCCATCTCTGGGGCAATGC -> GATACCCATCTCTGGGGCAATGCC
GATACCCATCTCTGGGGCAATGCC -> ATACCCATCTCTGGGGCAATGCCT
CAGCCTGACTGCCCGTTGTTTTCG -> AGCCTGACTGCCCGTTGTTTTCGG
CTTACTTACTAAGAACGCTGTTGG -> TTACTTACTAAGAACGCTGTTGGA
GCACCGGACTGATATTGCAGGGAA -> CACCGGACTGATATTGCAGGGAAG
GTTGGCATGAAGTTGATCGGTATC -> TTGGCATGAAGTTGATCGGTATCA
TCATTCTCGGCCGTTGACGCCCGT -> CATTCTCGGCCGTTGACGCCCGTT
GATACAGGTGCCAACTCGGGTGTG -> ATACAGGTGCCAACTCGGGTGTGT
GCTCAACTCGCTGAAAACATATTA -> CTCAACTCGCTGAAAACATATTAC
TTCTAGGGCCCCAGTGCATTGACA -> TCTAGGGCCCCAGTGCATTGACAT
TAGCACGATATGCACCTCGTCACA -> AGCACGATATGCACCTCGTCACAA
TTGAGGTGGCTTCCCCCCTTCTTA -> TGAGGTGGCTTCCCCCCTTCTTAC
ACTCCTCTGCATATATCATCGGGC -> CTCCTCTGCATATATCATCGGGCT
CACCAGCCTGACTGCCCGTTGTTT -> ACCAGCCTGACTGCCCGTTGTTTT
ATGCGGTACGGAAATGAGACGCGA -> TGCGGTACGGAAATGAGACGCGAT
TCGGGCTGCCATCGAAGCAGGAGG -> CGGGCTGCCATCGAAGCAGGAGGC
GTCGAATAGTTACGTGGCTGATAC -> TCGAATAGTTACGTGGCTGATACA
CTCGAATTGTCTGTGCCCACTGCC -> TCGAATTGTCTGTGCCCACTGCCA
AATCGAACTCTCTATCGTCATTCC -> ATCGAACTCTCTATCGTCATTCCG
GCTGTGCGCCAAAAGATGACCGAC -> CTGTGCGCCAAAAGATGACCGACG
ACTACCAATAGGTTATCTGGGAGA -> CTACCAATAGGTTATCTGGGAGAA
GGCAACTACCAATAGGTTATCTGG -> GCAACTACCAATAGGTTATCTGGG
CCGGTGTGCTGTATTTGATGCACT -> CGGTGTGCTGTATTTGATGCACTG
GTTATCTGGGAGAATCTTCCACCA -> TTATCTGGGAGAATCTTCCACCAA
GTTCCCGCTCTGCTTATTACAGTG -> TTCCCGCTCTGCTTATTACAGTGG
TTCGACGACTCCTCTGCATATATC -> TCGACGACTCCTCTGCATATATCA
CGGGCCGGAGGAGGCAGAGACCAG -> GGGCCGGAGGAGGCAGAGACCAGG
CCCATTTGAGGTGCCTGTAGTTCT -> CCATTTGAGGTGCCTGTAGTTCTA
TTGTTCAATATTCAGCTCGAATTG -> TGTTCAATATTCAGCTCGAATTGT
AGGTCAGTGAAGATGCAATCATGT -> GGTCAGTGAAGATGCAATCATGTC
GCGCGTTGTTCAATATTCAGCTCG -> CGCGTTGTTCAATATTCAGCTCGA
CGACGACTCCTCTGCATATATCAT -> GACGACTCCTCTGCATATATCATC
CCTACCCGTAAGCCTGGGGATTGA -> CTACCCGTAAGCCTGGGGATTGAT
AACGGTGTCGGATACCCATCTCTG -> ACGGTGTCGGATACCCATCTCTGG
CGCCCGTTATCAGTGCATGAGGGT -> GCCCGTTATCAGTGCATGAGGGTA
TAGCCCTTCTTTTGTTCCCGCTCT -> AGCCCTTCTTTTGTTCCCGCTCTG
ATTCGACGACTCCTCTGCATATAT -> TTCGACGACTCCTCTGCATATATC
TGGCCGGTCAATTGTGCGGGCGAG -> GGCCGGTCAATTGTGCGGGCGAGC
CTTTTGTTCCCGCTCTGCTTATTA -> TTTTGTTCCCGCTCTGCTTATTAC
TCGGTCACACGCCCGGTGTGCTGT -> CGGTCACACGCCCGGTGTGCTGTA
CTAGGGCCCCAGTGCATTGACATA -> TAGGGCCCCAGTGCATTGACATAG
ATGTAGCCCTTCTTTTGTTCCCGC -> TGTAGCCCTTCTTTTGTTCCCGCT
CCAGGCCTGTTGATTGTAGACGGT -> CAGGCCTGTTGATTGTAGACGGTT
TGGGGCAATGCCTAAACCAGGTGC -> GGGGCAATGCCTAAACCAGGTGCG
AGGTGGCTTCCCCCCTTCTTACCC -> GGTGGCTTCCCCCCTTCTTACCCA
CCCGATGTAGCCCTTCTTTTGTTC -> CCGATGTAGCCCTTCTTTTGTTCC
GAAGTGTGCGTGACTTCAAAAGGA -> AAGTGTGCGTGACTTCAAAAGGAC
TCCGGCGCCGTCGGTCACACGCCC -> CCGGCGCCGTCGGTCACACGCCCG
GACTCGACTCGTTCTGTCTATTAC -> ACTCGACTCGTTCTGTCTATTACA
CGTGCTTATCCACGGACGTGACAA -> GTGCTTATCCACGGACGTGACAAC
GGCAATGCCTAAACCAGGTGCGCA -> GCAATGCCTAAACCAGGTGCGCAT
AGCACGATATGCACCTCGTCACAA -> GCACGATATGCACCTCGTCACAAT
TGCATATATCATCGGGCTGCCATC -> GCATATATCATCGGGCTGCCATCG
CTGGGGCAATGCCTAAACCAGGTG -> TGGGGCAATGCCTAAACCAGGTGC
TCTCTGGGGCAATGCCTAAACCAG -> CTCTGGGGCAATGCCTAAACCAGG
CTACCCGTAAGCCTGGGGATTGAT -> TACCCGTAAGCCTGGGGATTGATA
AGCCTGACTGCCCGTTGTTTTCGG -> GCCTGACTGCCCGTTGTTTTCGGC
TATTACAAGCGTGCTTATCCACGG -> ATTACAAGCGTGCTTATCCACGGA
TCGACTCGTTCTGTCTATTACAAG -> CGACTCGTTCTGTCTATTACAAGC
AAGATGACCGACGGAGAAGTCTAC -> AGATGACCGACGGAGAAGTCTACT
TCTGGGCGTCGAGAGCATCCTCTA -> CTGGGCGTCGAGAGCATCCTCTAG
GGCTTCCCCCCTTCTTACCCATTT -> GCTTCCCCCCTTCTTACCCATTTG
GTCTACTAAAGTATTGAGGTGGCT -> TCTACTAAAGTATTGAGGTGGCTT
GTGTTCTATCTTGCCGACTTTCCA -> TGTTCTATCTTGCCGACTTTCCAG
ATGCACCTCGTCACAATCGAACTC -> TGCACCTCGTCACAATCGAACTCT
CTCGCTGAAAACATATTACTCATT -> TCGCTGAAAACATATTACTCATTC
AGAGTGCTGGGCTTGCCTTTAGTG -> GAGTGCTGGGCTTGCCTTTAGTGA
GCCCCGATGTAGCCCTTCTTTTGT -> CCCCGATGTAGCCCTTCTTTTGTT
CCTCTTGCGCGACGTATTAAGCTA -> CTCTTGCGCGACGTATTAAGCTAT
GATATTGTGCCCGGGGAACTGAGA -> ATATTGTGCCCGGGGAACTGAGAT
GCATACGAACCCGCCAGGAATGCT -> CATACGAACCCGCCAGGAATGCTG
GAGTGTAATGTACTAAGTCCAGCT -> AGTGTAATGTACTAAGTCCAGCTA
CTGCCATCGAAGCAGGAGGCGGGC -> TGCCATCGAAGCAGGAGGCGGGCC
TTACCCATTTGAGGTGCCTGTAGT -> TACCCATTTGAGGTGCCTGTAGTT
GCCCTTCTTTTGTTCCCGCTCTGC -> CCCTTCTTTTGTTCCCGCTCTGCT
GAACCCGCCAGGAATGCTGGTTAG -> AACCCGCCAGGAATGCTGGTTAGA
ATCTTATCTATGATCGTCTTATTT -> TCTTATCTATGATCGTCTTATTTC
TTAGAGTGCTGGGCTTGCCTTTAG -> TAGAGTGCTGGGCTTGCCTTTAGT
CACTGCTCGTTCATGTCTAATTGC -> ACTGCTCGTTCATGTCTAATTGCC
AGGATTGCCGATATGTTGCATACG -> GGATTGCCGATATGTTGCATACGA
TGCCCGGGGAACTGAGATAAAGAG -> GCCCGGGGAACTGAGATAAAGAGG
CACCTCAATGAAGTGTGCGTGACT -> ACCTCAATGAAGTGTGCGTGACTT
CGTCAAGGCTCGGTTCGTATGCCT -> GTCAAGGCTCGGTTCGTATGCCTC
AGGAGGCAGAGACCAGGATTGCCG -> GGAGGCAGAGACCAGGATTGCCGA
ACGTATTAAGCTATTGTTGAAGCC -> CGTATTAAGCTATTGTTGAAGCCT
GTTACGTGGCTGATACAGGTGCCA -> TTACGTGGCTGATACAGGTGCCAA
TTTTACGTCGAATAGTTACGTGGC -> TTTACGTCGAATAGTTACGTGGCT
GTCAGTGAAGATGCAATCATGTCT -> TCAGTGAAGATGCAATCATGTCTT
CCAAAAGATAGAGGTATCGAGTGT -> CAAAAGATAGAGGTATCGAGTGTA
CACACGCCCGGTGTGCTGTATTTG -> ACACGCCCGGTGTGCTGTATTTGA
GTTAACAATCTTTGCGCCCGAATC -> TTAACAATCTTTGCGCCCGAATCT
GAGGTATCGAGTGTAATGTACTAA -> AGGTATCGAGTGTAATGTACTAAG
TGTTCAATATTCAGCTCGAATTGT -> GTTCAATATTCAGCTCGAATTGTC
ATTACAGTGGCGCTCTGGGCGTCG -> TTACAGTGGCGCTCTGGGCGTCGA
GATTGTAGACGGTTCTGGTGGATG -> ATTGTAGACGGTTCTGGTGGATGG
GAGGCGGGCCGGAGGAGGCAGAGA -> AGGCGGGCCGGAGGAGGCAGAGAC
AGCACCGGACTGATATTGCAGGGA -> GCACCGGACTGATATTGCAGGGAA
CATAATGCTGTGCGCCAAAAGATG -> ATAATGCTGTGCGCCAAAAGATGA
AGTGTAATGTACTAAGTCCAGCTA -> GTGTAATGTACTAAGTCCAGCTAC
AATCTTATCTATGATCGTCTTATT -> ATCTTATCTATGATCGTCTTATTT
CATTTGAGGTGCCTGTAGTTCTAT -> ATTTGAGGTGCCTGTAGTTCTATT
CTCGGTTCGTATGCCTCTTGCGCG -> TCGGTTCGTATGCCTCTTGCGCGA
TAGGTATTCGCGTTGCCGATTCAA -> AGGTATTCGCGTTGCCGATTCAAG
TAAGTCCAGCTACGTGGCCGGTCA -> AAGTCCAGCTACGTGGCCGGTCAA
AGTGCATGAGGGTAAAAGCGTCAA -> GTGCATGAGGGTAAAAGCGTCAAG
GAGCCCGCCTACCAGGCCTGTTGA -> AGCCCGCCTACCAGGCCTGTTGAT
GTAGCTCAACTCGCTGAAAACATA -> TAGCTCAACTCGCTGAAAACATAT
GCTGATACAGGTGCCAACTCGGGT -> CTGATACAGGTGCCAACTCGGGTG
CGTATGCCTCTTGCGCGACGTATT -> GTATGCCTCTTGCGCGACGTATTA
GTGCGCGTTGTTCAATATTCAGCT -> TGCGCGTTGTTCAATATTCAGCTC
ACTCGACTCGTTCTGTCTATTACA -> CTCGACTCGTTCTGTCTATTACAA
CAGCTCGAATTGTCTGTGCCCACT -> AGCTCGAATTGTCTGTGCCCACTG
GCCGGTCAATTGTGCGGGCGAGCA -> CCGGTCAATTGTGCGGGCGAGCAC
CAATTGTGCGGGCGAGCACCGGAC -> AATTGTGCGGGCGAGCACCGGACT
TAAGCCGCGGAGAGTAGAGTTAAG -> AAGCCGCGGAGAGTAGAGTTAAGT
GAAATTGCAGCCTCTTTTTTTCTG -> AAATTGCAGCCTCTTTTTTTCTGT
GCGCTCTGGGCGTCGAGAGCATCC -> CGCTCTGGGCGTCGAGAGCATCCT
CGGGGCTAAGGCTCGTTAACAATC -> GGGGCTAAGGCTCGTTAACAATCT
CCCGGTGTGCTGTATTTGATGCAC -> CCGGTGTGCTGTATTTGATGCACT
GCACCTCGTCACAATCGAACTCTC -> CACCTCGTCACAATCGAACTCTCT
GCCCACTGCCAGTGGATCCGCGCG -> CCCACTGCCAGTGGATCCGCGCGG
GAGGTGCGGGCAACTACCAATAGG -> AGGTGCGGGCAACTACCAATAGGT
GAGGAGGCAGAGACCAGGATTGCC -> AGGAGGCAGAGACCAGGATTGCCG
GGCGCTCTGGGCGTCGAGAGCATC -> GCGCTCTGGGCGTCGAGAGCATCC
AAACGAGACGGAGTAGCACGATAT -> AACGAGACGGAGTAGCACGATATG
TCATTCCGTGAATTATCCGTAGTT -> CATTCCGTGAATTATCCGTAGTTC
AGAATCTTCCACCAAGAATGCCCC -> GAATCTTCCACCAAGAATGCCCCG
AAGAGGTCAGTGAAGATGCAATCA -> AGAGGTCAGTGAAGATGCAATCAT
TAACAATCTTTGCGCCCGAATCTT -> AACAATCTTTGCGCCCGAATCTTA
TGGTATCGATGATTTGGTATTTAC -> GGTATCGATGATTTGGTATTTACG
CTAAACCAGGTGCGCATAATCCGG -> TAAACCAGGTGCGCATAATCCGGC
GTGCCCGGGGAACTGAGATAAAGA -> TGCCCGGGGAACTGAGATAAAGAG
ATCGTCTTATTTCCAGTGACACTA -> TCGTCTTATTTCCAGTGACACTAT
GAAGCCTACCCGTAAGCCTGGGGA -> AAGCCTACCCGTAAGCCTGGGGAT
GATGCACTGCTCGTTCATGTCTAA -> ATGCACTGCTCGTTCATGTCTAAT
TGCCAACTCGGGTGTGTTTGCGGG -> GCCAACTCGGGTGTGTTTGCGGGG
CCGGGGGGAAGCCAGCCACCCATA -> CGGGGGGAAGCCAGCCACCCATAA
GAACGCTGTTGGACATGTTGGTAT -> AACGCTGTTGGACATGTTGGTATC
GTGAGGTAGCTCAACTCGCTGAAA -> TGAGGTAGCTCAACTCGCTGAAAA
TCAATGAAGTGTGCGTGACTTCAA -> CAATGAAGTGTGCGTGACTTCAAA
CGTGGCTGATACAGGTGCCAACTC -> GTGGCTGATACAGGTGCCAACTCG
GAGGGTAAAAGCGTCAAGGCTCGG -> AGGGTAAAAGCGTCAAGGCTCGGT
TTCCGTGAATTATCCGTAGTTCCT -> TCCGTGAATTATCCGTAGTTCCTA
CGTGAATTATCCGTAGTTCCTACG -> GTGAATTATCCGTAGTTCCTACGC
AAGAATGACTCGACTCGTTCTGTC -> AGAATGACTCGACTCGTTCTGTCT
CCAATAGGTTATCTGGGAGAATCT -> CAATAGGTTATCTGGGAGAATCTT
GGAGAATCTTCCACCAAGAATGCC -> GAGAATCTTCCACCAAGAATGCCC
CGCGATATCGAGCCCGCCTACCAG -> GCGATATCGAGCCCGCCTACCAGG
GTATTTGATGCACTGCTCGTTCAT -> TATTTGATGCACTGCTCGTTCATG
TGCCATCGAAGCAGGAGGCGGGCC -> GCCATCGAAGCAGGAGGCGGGCCG
CGTAAGCCTGGGGATTGATAAGCC -> GTAAGCCTGGGGATTGATAAGCCG
GCGGGCGAGCACCGGACTGATATT -> CGGGCGAGCACCGGACTGATATTG
ATTCTCGGCCGTTGACGCCCGTTA -> TTCTCGGCCGTTGACGCCCGTTAT
TCCTACGCTCATTTTACGTCGAAT -> CCTACGCTCATTTTACGTCGAATA
ACACTATCCCGAAATTGCAGCCTC -> CACTATCCCGAAATTGCAGCCTCT
CTTCCACCAAGAATGCCCCGATGT -> TTCCACCAAGAATGCCCCGATGTA
TCATCGGGCTGCCATCGAAGCAGG -> CATCGGGCTGCCATCGAAGCAGGA
GCAATGCCTAAACCAGGTGCGCAT -> CAATGCCTAAACCAGGTGCGCATA
GGTATCGATGATTTGGTATTTACG -> GTATCGATGATTTGGTATTTACGC
TTGCATACGAACCCGCCAGGAATG -> TGCATACGAACCCGCCAGGAATGC
TACGGAAATGAGACGCGATATCGA -> ACGGAAATGAGACGCGATATCGAG
CGCGTTGCCGATTCAAGGCAGATT -> GCGTTGCCGATTCAAGGCAGATTC
CTCGGGTGTGTTTGCGGGGCTAAG -> TCGGGTGTGTTTGCGGGGCTAAGG
CAGTGGATCCGCGCGGTACCGTGT -> AGTGGATCCGCGCGGTACCGTGTT
AAGGCTCGTTAACAATCTTTGCGC -> AGGCTCGTTAACAATCTTTGCGCC
TTACGCCGCATACTAGTCGTGATG -> TACGCCGCATACTAGTCGTGATGC
CCTGAGGTGCGGGCAACTACCAAT -> CTGAGGTGCGGGCAACTACCAATA
TCCAGCACCTCAATGAAGTGTGCG -> CCAGCACCTCAATGAAGTGTGCGT
TTGCCCCAAAAGATAGAGGTATCG -> TGCCCCAAAAGATAGAGGTATCGA
GGGCGAGCACCGGACTGATATTGC -> GGCGAGCACCGGACTGATATTGCA
GATGTAGCCCTTCTTTTGTTCCCG -> ATGTAGCCCTTCTTTTGTTCCCGC
CCCGAAATTGCAGCCTCTTTTTTT -> CCGAAATTGCAGCCTCTTTTTTTC
AGTATTGAGGTGGCTTCCCCCCTT -> GTATTGAGGTGGCTTCCCCCCTTC
AGACCAGGATTGCCGATATGTTGC -> GACCAGGATTGCCGATATGTTGCA
TAGCTCAACTCGCTGAAAACATAT -> AGCTCAACTCGCTGAAAACATATT
TCTTGCCGACTTTCCAGGTAAAAT -> CTTGCCGACTTTCCAGGTAAAATG
AAAAGGACTCCCGGGGGGAAGCCA -> AAAGGACTCCCGGGGGGAAGCCAG
CTATCCCGAAATTGCAGCCTCTTT -> TATCCCGAAATTGCAGCCTCTTTT
CACTGCCAGTGGATCCGCGCGGTA -> ACTGCCAGTGGATCCGCGCGGTAC
CACTATCCCGAAATTGCAGCCTCT -> ACTATCCCGAAATTGCAGCCTCTT
CGGGGAACTGAGATAAAGAGGTAA -> GGGGAACTGAGATAAAGAGGTAAC
CATACTAGTCGTGATGCGGTACGG -> ATACTAGTCGTGATGCGGTACGGA
AGTAGAGTTAAGTTGGCATGAAGT -> GTAGAGTTAAGTTGGCATGAAGTT
AGGACTCCCGGGGGGAAGCCAGCC -> GGACTCCCGGGGGGAAGCCAGCCA
ACTTTCCAGGTAAAATGCCCTTAA -> CTTTCCAGGTAAAATGCCCTTAAC
CCACCAAGAATGCCCCGATGTAGC -> CACCAAGAATGCCCCGATGTAGCC
CATCTCTGGGGCAATGCCTAAACC -> ATCTCTGGGGCAATGCCTAAACCA
GACGTGACAACTTGAAGAGGTCAG -> ACGTGACAACTTGAAGAGGTCAGT
TGGGAGAATCTTCCACCAAGAATG -> GGGAGAATCTTCCACCAAGAATGC
CCAGCTACGTGGCCGGTCAATTGT -> CAGCTACGTGGCCGGTCAATTGTG
CACGCCCGGTGTGCTGTATTTGAT -> ACGCCCGGTGTGCTGTATTTGATG
AGAGACCAGGATTGCCGATATGTT -> GAGACCAGGATTGCCGATATGTTG
TAAGAATGACTCGACTCGTTCTGT -> AAGAATGACTCGACTCGTTCTGTC
ATCGATGATTTGGTATTTACGCCG -> TCGATGATTTGGTATTTACGCCGC
AAGCATAAGGAAGCCACCAGCCTG -> AGCATAAGGAAGCCACCAGCCTGA
GGTCACACGCCCGGTGTGCTGTAT -> GTCACACGCCCGGTGTGCTGTATT
GTAGTTCTATTCGACGACTCCTCT -> TAGTTCTATTCGACGACTCCTCTG
AACTGAGATAAAGAGGTAACAAAC -> ACTGAGATAAAGAGGTAACAAACG
TTAGGTATTCGCGTTGCCGATTCA -> TAGGTATTCGCGTTGCCGATTCAA
GCGTTGCCGATTCAAGGCAGATTC -> CGTTGCCGATTCAAGGCAGATTCC
GGAAGCATAAGGAAGCCACCAGCC -> GAAGCATAAGGAAGCCACCAGCCT
TAGTTACGTGGCTGATACAGGTGC -> AGTTACGTGGCTGATACAGGTGCC
TCTAGGTAAACGGTGTCGGATACC -> CTAGGTAAACGGTGTCGGATACCC
GTGAATTATCCGTAGTTCCTACGC -> TGAATTATCCGTAGTTCCTACGCT
ATGCCCTTAACCCATTTCGCCTGT -> TGCCCTTAACCCATTTCGCCTGTG
TAAGAACGCTGTTGGACATGTTGG -> AAGAACGCTGTTGGACATGTTGGT
TTGTTGAAGCCTACCCGTAAGCCT -> TGTTGAAGCCTACCCGTAAGCCTG
TTGTTCCCGCTCTGCTTATTACAG -> TGTTCCCGCTCTGCTTATTACAGT
ATGCACTGCTCGTTCATGTCTAAT -> TGCACTGCTCGTTCATGTCTAATT
ATCTTTGCGCCCGAATCTTATCTA -> TCTTTGCGCCCGAATCTTATCTAT
CGAATTGTCTGTGCCCACTGCCAG -> GAATTGTCTGTGCCCACTGCCAGT
ATGCTGGTTAGAGTGCTGGGCTTG -> TGCTGGTTAGAGTGCTGGGCTTGC
TCCCCCCTTCTTACCCATTTGAGG -> CCCCCCTTCTTACCCATTTGAGGT
GCGACGTATTAAGCTATTGTTGAA -> CGACGTATTAAGCTATTGTTGAAG
CGGGGGGAAGCCAGCCACCCATAA -> GGGGGGAAGCCAGCCACCCATAAC
TATCGATGATTTGGTATTTACGCC -> ATCGATGATTTGGTATTTACGCCG
CACCTCGTCACAATCGAACTCTCT -> ACCTCGTCACAATCGAACTCTCTA
TTCATTAAAGAAGACATGATATTG -> TCATTAAAGAAGACATGATATTGT
TCCTCTAGGTAAACGGTGTCGGAT -> CCTCTAGGTAAACGGTGTCGGATA
GCCAAAAGATGACCGACGGAGAAG -> CCAAAAGATGACCGACGGAGAAGT
AGCTACGTGGCCGGTCAATTGTGC -> GCTACGTGGCCGGTCAATTGTGCG
CGATGTAGCCCTTCTTTTGTTCCC -> GATGTAGCCCTTCTTTTGTTCCCG
TGGGGATTGATAAGCCGCGGAGAG -> GGGGATTGATAAGCCGCGGAGAGT
AGTTAAGTTGGCATGAAGTTGATC -> GTTAAGTTGGCATGAAGTTGATCG
TACAAGCGTGCTTATCCACGGACG -> ACAAGCGTGCTTATCCACGGACGT
TGCGGGCAACTACCAATAGGTTAT -> GCGGGCAACTACCAATAGGTTATC
TGAGGGTAAAAGCGTCAAGGCTCG -> GAGGGTAAAAGCGTCAAGGCTCGG
GCGGGGCTAAGGCTCGTTAACAAT -> CGGGGCTAAGGCTCGTTAACAATC
TGTCTATTACAAGCGTGCTTATCC -> GTCTATTACAAGCGTGCTTATCCA
ATGCCTCTTGCGCGACGTATTAAG -> TGCCTCTTGCGCGACGTATTAAGC
TAAAGTATTGAGGTGGCTTCCCCC -> AAAGTATTGAGGTGGCTTCCCCCC
CGGTGTCGGATACCCATCTCTGGG -> GGTGTCGGATACCCATCTCTGGGG
TAGAGTTAAGTTGGCATGAAGTTG -> AGAGTTAAGTTGGCATGAAGTTGA
TGACATAGTCACGCCAAGCGGGTG -> GACATAGTCACGCCAAGCGGGTGT
TATTTCCAGTGACACTATCCCGAA -> ATTTCCAGTGACACTATCCCGAAA
TTGCAGCCTCTTTTTTTCTGTATC -> TGCAGCCTCTTTTTTTCTGTATCA
TGAAGATGCAATCATGTCTTACTT -> GAAGATGCAATCATGTCTTACTTA
CTACGCTCATTTTACGTCGAATAG -> TACGCTCATTTTACGTCGAATAGT
GAAGCCAGCCACCCATAACTCTAA -> AAGCCAGCCACCCATAACTCTAAC
GCGTGACTTCAAAAGGACTCCCGG -> CGTGACTTCAAAAGGACTCCCGGG
TATCAGTGCATGAGGGTAAAAGCG -> ATCAGTGCATGAGGGTAAAAGCGT
GCTCATTTTACGTCGAATAGTTAC -> CTCATTTTACGTCGAATAGTTACG
GGCTCGTTAACAATCTTTGCGCCC -> GCTCGTTAACAATCTTTGCGCCCG
CAACTTGAAGAGGTCAGTGAAGAT -> AACTTGAAGAGGTCAGTGAAGATG
CTCGTCACAATCGAACTCTCTATC -> TCGTCACAATCGAACTCTCTATCG
GGCCGGTCAATTGTGCGGGCGAGC -> GCCGGTCAATTGTGCGGGCGAGCA
CGTTAACAATCTTTGCGCCCGAAT -> GTTAACAATCTTTGCGCCCGAATC
ATCGGGCTGCCATCGAAGCAGGAG -> TCGGGCTGCCATCGAAGCAGGAGG
TCGTTAACAATCTTTGCGCCCGAA -> CGTTAACAATCTTTGCGCCCGAAT
GTTAAGTTGGCATGAAGTTGATCG -> TTAAGTTGGCATGAAGTTGATCGG
CAAGCGGGTGTTCTATCTTGCCGA -> AAGCGGGTGTTCTATCTTGCCGAC
GCCTGACTGCCCGTTGTTTTCGGC -> CCTGACTGCCCGTTGTTTTCGGCT
AACTTGAAGAGGTCAGTGAAGATG -> ACTTGAAGAGGTCAGTGAAGATGC
TGGGCGACTAAGAATGACTCGACT -> GGGCGACTAAGAATGACTCGACTC
CTTATCTATGATCGTCTTATTTCC -> TTATCTATGATCGTCTTATTTCCA
CTCCTCTGCATATATCATCGGGCT -> TCCTCTGCATATATCATCGGGCTG
TACTTACTAAGAACGCTGTTGGAC -> ACTTACTAAGAACGCTGTTGGACA
ATCGAGTGTAATGTACTAAGTCCA -> TCGAGTGTAATGTACTAAGTCCAG
ACGATATGCACCTCGTCACAATCG -> CGATATGCACCTCGTCACAATCGA
CATAGTCACGCCAAGCGGGTGTTC -> ATAGTCACGCCAAGCGGGTGTTCT
CGCGGAGAGTAGAGTTAAGTTGGC -> GCGGAGAGTAGAGTTAAGTTGGCA
ATGATATTGTGCCCGGGGAACTGA -> TGATATTGTGCCCGGGGAACTGAG
GGATGGAAGCATAAGGAAGCCACC -> GATGGAAGCATAAGGAAGCCACCA
TGCCAGTGGATCCGCGCGGTACCG -> GCCAGTGGATCCGCGCGGTACCGT
GCCGATATGTTGCATACGAACCCG -> CCGATATGTTGCATACGAACCCGC
GGAGAAGTCTACTAAAGTATTGAG -> GAGAAGTCTACTAAAGTATTGAGG
TCAGCTCGAATTGTCTGTGCCCAC -> CAGCTCGAATTGTCTGTGCCCACT
CCTTAACCCATTTCGCCTGTGAGG -> CTTAACCCATTTCGCCTGTGAGGT
CCGCATACTAGTCGTGATGCGGTA -> CGCATACTAGTCGTGATGCGGTAC
GGGAGAATCTTCCACCAAGAATGC -> GGAGAATCTTCCACCAAGAATGCC
TCGGCCGTTGACGCCCGTTATCAG -> CGGCCGTTGACGCCCGTTATCAGT
ACCCATCTCTGGGGCAATGCCTAA -> CCCATCTCTGGGGCAATGCCTAAA
TGAAAACATATTACTCATTCTCGG -> GAAAACATATTACTCATTCTCGGC
TATTCGCGTTGCCGATTCAAGGCA -> ATTCGCGTTGCCGATTCAAGGCAG
TCGTTCATGTCTAATTGCCCCAAA -> CGTTCATGTCTAATTGCCCCAAAA
TCTATCTTGCCGACTTTCCAGGTA -> CTATCTTGCCGACTTTCCAGGTAA
TCACGCCAAGCGGGTGTTCTATCT -> CACGCCAAGCGGGTGTTCTATCTT
GTCCAGCTACGTGGCCGGTCAATT -> TCCAGCTACGTGGCCGGTCAATTG
TAGGTTATCTGGGAGAATCTTCCA -> AGGTTATCTGGGAGAATCTTCCAC
GTGCCAACTCGGGTGTGTTTGCGG -> TGCCAACTCGGGTGTGTTTGCGGG
GCAGATTCCAGCACCTCAATGAAG -> CAGATTCCAGCACCTCAATGAAGT
TCTTTTGTTCCCGCTCTGCTTATT -> CTTTTGTTCCCGCTCTGCTTATTA
ACCCATTTGAGGTGCCTGTAGTTC -> CCCATTTGAGGTGCCTGTAGTTCT
AGCCGCGGAGAGTAGAGTTAAGTT -> GCCGCGGAGAGTAGAGTTAAGTTG
GCTAAGGCTCGTTAACAATCTTTG -> CTAAGGCTCGTTAACAATCTTTGC
TTGAAGAGGTCAGTGAAGATGCAA -> TGAAGAGGTCAGTGAAGATGCAAT
GCTCGGTTCGTATGCCTCTTGCGC -> CTCGGTTCGTATGCCTCTTGCGCG
GCAATCATGTCTTACTTACTAAGA -> CAATCATGTCTTACTTACTAAGAA
CACGATATGCACCTCGTCACAATC -> ACGATATGCACCTCGTCACAATCG
TAACCTGAGGTGCGGGCAACTACC -> AACCTGAGGTGCGGGCAACTACCA
TCCCGGGGGGAAGCCAGCCACCCA -> CCCGGGGGGAAGCCAGCCACCCAT
AGCATCCTCTAGGTAAACGGTGTC -> GCATCCTCTAGGTAAACGGTGTCG
GAGAGTAGAGTTAAGTTGGCATGA -> AGAGTAGAGTTAAGTTGGCATGAA
GAAGTTGATCGGTATCATAATGCT -> AAGTTGATCGGTATCATAATGCTG
TAACTCTAACCTGAGGTGCGGGCA -> AACTCTAACCTGAGGTGCGGGCAA
TGATATTGCAGGGAAGAAGGCATG -> GATATTGCAGGGAAGAAGGCATGA
GAGAATCTTCCACCAAGAATGCCC -> AGAATCTTCCACCAAGAATGCCCC
GATATTGCAGGGAAGAAGGCATGA -> ATATTGCAGGGAAGAAGGCATGAT
GCCGTCGGTCACACGCCCGGTGTG -> CCGTCGGTCACACGCCCGGTGTGC
ATTGACATAGTCACGCCAAGCGGG -> TTGACATAGTCACGCCAAGCGGGT
AGAGGTATCGAGTGTAATGTACTA -> GAGGTATCGAGTGTAATGTACTAA
AGTTCTATTCGACGACTCCTCTGC -> GTTCTATTCGACGACTCCTCTGCA
TTGACATAGTCACGCCAAGCGGGT -> TGACATAGTCACGCCAAGCGGGTG
GCATGAAGTTGATCGGTATCATAA -> CATGAAGTTGATCGGTATCATAAT
TGCCGATATGTTGCATACGAACCC -> GCCGATATGTTGCATACGAACCCG
ATTGTCTGTGCCCACTGCCAGTGG -> TTGTCTGTGCCCACTGCCAGTGGA
TCTGGGAGAATCTTCCACCAAGAA -> CTGGGAGAATCTTCCACCAAGAAT
GCATAATCCGGCGCCGTCGGTCAC -> CATAATCCGGCGCCGTCGGTCACA
AGTTGATCGGTATCATAATGCTGT -> GTTGATCGGTATCATAATGCTGTG
AGCTCGAATTGTCTGTGCCCACTG -> GCTCGAATTGTCTGTGCCCACTGC
CGACTCCTCTGCATATATCATCGG -> GACTCCTCTGCATATATCATCGGG
GTATTTACGCCGCATACTAGTCGT -> TATTTACGCCGCATACTAGTCGTG
TGATAATCTGGGCGACTAAGAATG -> GATAATCTGGGCGACTAAGAATGA
ATTCCAGCACCTCAATGAAGTGTG -> TTCCAGCACCTCAATGAAGTGTGC
GAAATGAGACGCGATATCGAGCCC -> AAATGAGACGCGATATCGAGCCCG
CACAATCGAACTCTCTATCGTCAT -> ACAATCGAACTCTCTATCGTCATT
ATAGTCACGCCAAGCGGGTGTTCT -> TAGTCACGCCAAGCGGGTGTTCTA
AAGCGTCAAGGCTCGGTTCGTATG -> AGCGTCAAGGCTCGGTTCGTATGC
GTTTTCGGCTGTCCTTCTAGGGCC -> TTTTCGGCTGTCCTTCTAGGGCCC
GGTGTGTTTGCGGGGCTAAGGCTC -> GTGTGTTTGCGGGGCTAAGGCTCG
TGTAGCCCTTCTTTTGTTCCCGCT -> GTAGCCCTTCTTTTGTTCCCGCTC
ACGCCGCATACTAGTCGTGATGCG -> CGCCGCATACTAGTCGTGATGCGG
GGTCAGTGAAGATGCAATCATGTC -> GTCAGTGAAGATGCAATCATGTCT
GTGCTGGGCTTGCCTTTAGTGATT -> TGCTGGGCTTGCCTTTAGTGATTC
CAATCGAACTCTCTATCGTCATTC -> AATCGAACTCTCTATCGTCATTCC
ATAACTCTAACCTGAGGTGCGGGC -> TAACTCTAACCTGAGGTGCGGGCA
AGGCAGAGACCAGGATTGCCGATA -> GGCAGAGACCAGGATTGCCGATAT
TGCTGGTTAGAGTGCTGGGCTTGC -> GCTGGTTAGAGTGCTGGGCTTGCC
TGGGCGTCGAGAGCATCCTCTAGG -> GGGCGTCGAGAGCATCCTCTAGGT
GTGACACTATCCCGAAATTGCAGC -> TGACACTATCCCGAAATTGCAGCC
TATTACAGTGGCGCTCTGGGCGTC -> ATTACAGTGGCGCTCTGGGCGTCG
AATCTGGGCGACTAAGAATGACTC -> ATCTGGGCGACTAAGAATGACTCG
AACTCTCTATCGTCATTCCGTGAA -> ACTCTCTATCGTCATTCCGTGAAT
CGTCGAGAGCATCCTCTAGGTAAA -> GTCGAGAGCATCCTCTAGGTAAAC
TGCTGGGCTTGCCTTTAGTGATTC -> GCTGGGCTTGCCTTTAGTGATTCA
ATTATCCGTAGTTCCTACGCTCAT -> TTATCCGTAGTTCCTACGCTCATT
GGTGTCGGATACCCATCTCTGGGG -> GTGTCGGATACCCATCTCTGGGGC
TCGTCATTCCGTGAATTATCCGTA -> CGTCATTCCGTGAATTATCCGTAG
AATGCCCCGATGTAGCCCTTCTTT -> ATGCCCCGATGTAGCCCTTCTTTT
ATTCATTAAAGAAGACATGATATT -> TTCATTAAAGAAGACATGATATTG
TGGTTAGAGTGCTGGGCTTGCCTT -> GGTTAGAGTGCTGGGCTTGCCTTT
TGTAGACGGTTCTGGTGGATGGAA -> GTAGACGGTTCTGGTGGATGGAAG
TGCACCTCGTCACAATCGAACTCT -> GCACCTCGTCACAATCGAACTCTC
CCAAGAATGCCCCGATGTAGCCCT -> CAAGAATGCCCCGATGTAGCCCTT
TCTGTCTATTACAAGCGTGCTTAT -> CTGTCTATTACAAGCGTGCTTATC
CGCGACGTATTAAGCTATTGTTGA -> GCGACGTATTAAGCTATTGTTGAA
CGCATACTAGTCGTGATGCGGTAC -> GCATACTAGTCGTGATGCGGTACG
TACCAGGCCTGTTGATTGTAGACG -> ACCAGGCCTGTTGATTGTAGACGG
GTAGACGGTTCTGGTGGATGGAAG -> TAGACGGTTCTGGTGGATGGAAGC
TGTAATGTACTAAGTCCAGCTACG -> GTAATGTACTAAGTCCAGCTACGT
ATTACTCATTCTCGGCCGTTGACG -> TTACTCATTCTCGGCCGTTGACGC
TGCTTATCCACGGACGTGACAACT -> GCTTATCCACGGACGTGACAACTT
GTGCGCATAATCCGGCGCCGTCGG -> TGCGCATAATCCGGCGCCGTCGGT
GGTGCGCATAATCCGGCGCCGTCG -> GTGCGCATAATCCGGCGCCGTCGG
TGACGCCCGTTATCAGTGCATGAG -> GACGCCCGTTATCAGTGCATGAGG
CAGGGAAGAAGGCATGATAATCTG -> AGGGAAGAAGGCATGATAATCTGG
TCAGTGAAGATGCAATCATGTCTT -> CAGTGAAGATGCAATCATGTCTTA
CCATAACTCTAACCTGAGGTGCGG -> CATAACTCTAACCTGAGGTGCGGG
ATTAAGCTATTGTTGAAGCCTACC -> TTAAGCTATTGTTGAAGCCTACCC
CTCTGGGCGTCGAGAGCATCCTCT -> TCTGGGCGTCGAGAGCATCCTCTA
TCGGTTCGTATGCCTCTTGCGCGA -> CGGTTCGTATGCCTCTTGCGCGAC
CAACTCGGGTGTGTTTGCGGGGCT -> AACTCGGGTGTGTTTGCGGGGCTA
GTCACGCCAAGCGGGTGTTCTATC -> TCACGCCAAGCGGGTGTTCTATCT
TGGGCTTGCCTTTAGTGATTCATT -> GGGCTTGCCTTTAGTGATTCATTA
ATCTTGCCGACTTTCCAGGTAAAA -> TCTTGCCGACTTTCCAGGTAAAAT
GGTAACAAACGAGACGGAGTAGCA -> GTAACAAACGAGACGGAGTAGCAC
CATATTACTCATTCTCGGCCGTTG -> ATATTACTCATTCTCGGCCGTTGA
CGATATGTTGCATACGAACCCGCC -> GATATGTTGCATACGAACCCGCCA
ATGGAAGCATAAGGAAGCCACCAG -> TGGAAGCATAAGGAAGCCACCAGC
ATTGCCGATATGTTGCATACGAAC -> TTGCCGATATGTTGCATACGAACC
ATATTACTCATTCTCGGCCGTTGA -> TATTACTCATTCTCGGCCGTTGAC
ATCATGTCTTACTTACTAAGAACG -> TCATGTCTTACTTACTAAGAACGC
CGATATCGAGCCCGCCTACCAGGC -> GATATCGAGCCCGCCTACCAGGCC
ATATCATCGGGCTGCCATCGAAGC -> TATCATCGGGCTGCCATCGAAGCA
GTTGTTCAATATTCAGCTCGAATT -> TTGTTCAATATTCAGCTCGAATTG
AGAATGCCCCGATGTAGCCCTTCT -> GAATGCCCCGATGTAGCCCTTCTT
GGTGGATGGAAGCATAAGGAAGCC -> GTGGATGGAAGCATAAGGAAGCCA
CCCGCCAGGAATGCTGGTTAGAGT -> CCGCCAGGAATGCTGGTTAGAGTG
ACGCTCATTTTACGTCGAATAGTT -> CGCTCATTTTACGTCGAATAGTTA
CAGCCTCTTTTTTTCTGTATCACG -> AGCCTCTTTTTTTCTGTATCACGA
AGTTACGTGGCTGATACAGGTGCC -> GTTACGTGGCTGATACAGGTGCCA
CCAGCCACCCATAACTCTAACCTG -> CAGCCACCCATAACTCTAACCTGA
AGACGCGATATCGAGCCCGCCTAC -> GACGCGATATCGAGCCCGCCTACC
GCCTACCAGGCCTGTTGATTGTAG -> CCTACCAGGCCTGTTGATTGTAGA
ACTCGCTGAAAACATATTACTCAT -> CTCGCTGAAAACATATTACTCATT
TTATCTGGGAGAATCTTCCACCAA -> TATCTGGGAGAATCTTCCACCAAG
GCTGTCCTTCTAGGGCCCCAGTGC -> CTGTCCTTCTAGGGCCCCAGTGCA
TTAACCCATTTCGCCTGTGAGGTA -> TAACCCATTTCGCCTGTGAGGTAG
CTTGCCGACTTTCCAGGTAAAATG -> TTGCCGACTTTCCAGGTAAAATGC
TTGCAGGGAAGAAGGCATGATAAT -> TGCAGGGAAGAAGGCATGATAATC
AGGCTCGTTAACAATCTTTGCGCC -> GGCTCGTTAACAATCTTTGCGCCC
CAATGAAGTGTGCGTGACTTCAAA -> AATGAAGTGTGCGTGACTTCAAAA
GAAGATGCAATCATGTCTTACTTA -> AAGATGCAATCATGTCTTACTTAC
GTATTGAGGTGGCTTCCCCCCTTC -> TATTGAGGTGGCTTCCCCCCTTCT
CGTGGCCGGTCAATTGTGCGGGCG -> GTGGCCGGTCAATTGTGCGGGCGA
AGCACCTCAATGAAGTGTGCGTGA -> GCACCTCAATGAAGTGTGCGTGAC
AAACGGTGTCGGATACCCATCTCT -> AACGGTGTCGGATACCCATCTCTG
ACGTGACAACTTGAAGAGGTCAGT -> CGTGACAACTTGAAGAGGTCAGTG
TGCAGGGAAGAAGGCATGATAATC -> GCAGGGAAGAAGGCATGATAATCT
AGGGCCCCAGTGCATTGACATAGT -> GGGCCCCAGTGCATTGACATAGTC
GGAGGCAGAGACCAGGATTGCCGA -> GAGGCAGAGACCAGGATTGCCGAT
TCCACCAAGAATGCCCCGATGTAG -> CCACCAAGAATGCCCCGATGTAGC
GGTGGCTTCCCCCCTTCTTACCCA -> GTGGCTTCCCCCCTTCTTACCCAT
GTTGATCGGTATCATAATGCTGTG -> TTGATCGGTATCATAATGCTGTGC
GCATAAGGAAGCCACCAGCCTGAC -> CATAAGGAAGCCACCAGCCTGACT
AGAGTTAAGTTGGCATGAAGTTGA -> GAGTTAAGTTGGCATGAAGTTGAT
GTTCCTACGCTCATTTTACGTCGA -> TTCCTACGCTCATTTTACGTCGAA
TAAACCAGGTGCGCATAATCCGGC -> AAACCAGGTGCGCATAATCCGGCG
TATGATCGTCTTATTTCCAGTGAC -> ATGATCGTCTTATTTCCAGTGACA
CATTAAAGAAGACATGATATTGTG -> ATTAAAGAAGACATGATATTGTGC
TCTTGCGCGACGTATTAAGCTATT -> CTTGCGCGACGTATTAAGCTATTG
CGCCCGAATCTTATCTATGATCGT -> GCCCGAATCTTATCTATGATCGTC
AGACATGATATTGTGCCCGGGGAA -> GACATGATATTGTGCCCGGGGAAC
ATGTCTAATTGCCCCAAAAGATAG -> TGTCTAATTGCCCCAAAAGATAGA
GATGTGCGCGTTGTTCAATATTCA -> ATGTGCGCGTTGTTCAATATTCAG
ACACGCCCGGTGTGCTGTATTTGA -> CACGCCCGGTGTGCTGTATTTGAT
CCCCTTCTTACCCATTTGAGGTGC -> CCCTTCTTACCCATTTGAGGTGCC
AGCCTGGGGATTGATAAGCCGCGG -> GCCTGGGGATTGATAAGCCGCGGA
TCCACGGACGTGACAACTTGAAGA -> CCACGGACGTGACAACTTGAAGAG
TGTCTAATTGCCCCAAAAGATAGA -> GTCTAATTGCCCCAAAAGATAGAG
CGATGTGCGCGTTGTTCAATATTC -> GATGTGCGCGTTGTTCAATATTCA
CTTCTAGGGCCCCAGTGCATTGAC -> TTCTAGGGCCCCAGTGCATTGACA
TGATAAGCCGCGGAGAGTAGAGTT -> GATAAGCCGCGGAGAGTAGAGTTA
CATGATAATCTGGGCGACTAAGAA -> ATGATAATCTGGGCGACTAAGAAT
GCGCGACGTATTAAGCTATTGTTG -> CGCGACGTATTAAGCTATTGTTGA
ACCAGGCCTGTTGATTGTAGACGG -> CCAGGCCTGTTGATTGTAGACGGT
ATCGAAGCAGGAGGCGGGCCGGAG -> TCGAAGCAGGAGGCGGGCCGGAGG
ACCTCGTCACAATCGAACTCTCTA -> CCTCGTCACAATCGAACTCTCTAT
CAGATTCCAGCACCTCAATGAAGT -> AGATTCCAGCACCTCAATGAAGTG
GCCCGGTGTGCTGTATTTGATGCA -> CCCGGTGTGCTGTATTTGATGCAC
CAAAAGATAGAGGTATCGAGTGTA -> AAAAGATAGAGGTATCGAGTGTAA
ATCATAATGCTGTGCGCCAAAAGA -> TCATAATGCTGTGCGCCAAAAGAT
AACCCGCCAGGAATGCTGGTTAGA -> ACCCGCCAGGAATGCTGGTTAGAG
AACCTGAGGTGCGGGCAACTACCA -> ACCTGAGGTGCGGGCAACTACCAA
ACATAGTCACGCCAAGCGGGTGTT -> CATAGTCACGCCAAGCGGGTGTTC
GGTATCATAATGCTGTGCGCCAAA -> GTATCATAATGCTGTGCGCCAAAA
TCGTTCTGTCTATTACAAGCGTGC -> CGTTCTGTCTATTACAAGCGTGCT
GCTACGTGGCCGGTCAATTGTGCG -> CTACGTGGCCGGTCAATTGTGCGG
GTATCGATGATTTGGTATTTACGC -> TATCGATGATTTGGTATTTACGCC
TGGCATGAAGTTGATCGGTATCAT -> GGCATGAAGTTGATCGGTATCATA
CCACCAGCCTGACTGCCCGTTGTT -> CACCAGCCTGACTGCCCGTTGTTT
CTGTGCCCACTGCCAGTGGATCCG -> TGTGCCCACTGCCAGTGGATCCGC
TCTAGGGCCCCAGTGCATTGACAT -> CTAGGGCCCCAGTGCATTGACATA
TGTTGGACATGTTGGTATCGATGA -> GTTGGACATGTTGGTATCGATGAT
ACGGACGTGACAACTTGAAGAGGT -> CGGACGTGACAACTTGAAGAGGTC
AAGTCCAGCTACGTGGCCGGTCAA -> AGTCCAGCTACGTGGCCGGTCAAT
ATATATCATCGGGCTGCCATCGAA -> TATATCATCGGGCTGCCATCGAAG
TCTCTATCGTCATTCCGTGAATTA -> CTCTATCGTCATTCCGTGAATTAT
ACTCCCGGGGGGAAGCCAGCCACC -> CTCCCGGGGGGAAGCCAGCCACCC
TTTCCAGGTAAAATGCCCTTAACC -> TTCCAGGTAAAATGCCCTTAACCC
TGATGCGGTACGGAAATGAGACGC -> GATGCGGTACGGAAATGAGACGCG
GGCATGATAATCTGGGCGACTAAG -> GCATGATAATCTGGGCGACTAAGA
GAGTTAAGTTGGCATGAAGTTGAT -> AGTTAAGTTGGCATGAAGTTGATC
CCGATGTAGCCCTTCTTTTGTTCC -> CGATGTAGCCCTTCTTTTGTTCCC
CCGTTGTTTTCGGCTGTCCTTCTA -> CGTTGTTTTCGGCTGTCCTTCTAG
TGCCTTTAGTGATTCATTAAAGAA -> GCCTTTAGTGATTCATTAAAGAAG
GACATAGTCACGCCAAGCGGGTGT -> ACATAGTCACGCCAAGCGGGTGTT
GCTGGGCTTGCCTTTAGTGATTCA -> CTGGGCTTGCCTTTAGTGATTCAT
ATGCCTAAACCAGGTGCGCATAAT -> TGCCTAAACCAGGTGCGCATAATC
AATTGCAGCCTCTTTTTTTCTGTA -> ATTGCAGCCTCTTTTTTTCTGTAT
CTATGATCGTCTTATTTCCAGTGA -> TATGATCGTCTTATTTCCAGTGAC
TGCGCCAAAAGATGACCGACGGAG -> GCGCCAAAAGATGACCGACGGAGA
CGAGAGCATCCTCTAGGTAAACGG -> GAGAGCATCCTCTAGGTAAACGGT
CCCGAATCTTATCTATGATCGTCT -> CCGAATCTTATCTATGATCGTCTT
ATCCGCGCGGTACCGTGTTGGGGA -> TCCGCGCGGTACCGTGTTGGGGAT
ACATGATATTGTGCCCGGGGAACT -> CATGATATTGTGCCCGGGGAACTG
AATTGTGCGGGCGAGCACCGGACT -> ATTGTGCGGGCGAGCACCGGACTG
CCGTAAGCCTGGGGATTGATAAGC -> CGTAAGCCTGGGGATTGATAAGCC
GCATTGACATAGTCACGCCAAGCG -> CATTGACATAGTCACGCCAAGCGG
CTCTGGGGCAATGCCTAAACCAGG -> TCTGGGGCAATGCCTAAACCAGGT
GTAGCACGATATGCACCTCGTCAC -> TAGCACGATATGCACCTCGTCACA
TTTGATGCACTGCTCGTTCATGTC -> TTGATGCACTGCTCGTTCATGTCT
CAGTGCATTGACATAGTCACGCCA -> AGTGCATTGACATAGTCACGCCAA
CCAGTGCATTGACATAGTCACGCC -> CAGTGCATTGACATAGTCACGCCA
AGCCCTTCTTTTGTTCCCGCTCTG -> GCCCTTCTTTTGTTCCCGCTCTGC
CGAGACGGAGTAGCACGATATGCA -> GAGACGGAGTAGCACGATATGCAC
AGCCCGCCTACCAGGCCTGTTGAT -> GCCCGCCTACCAGGCCTGTTGATT
TTCCAGCACCTCAATGAAGTGTGC -> TCCAGCACCTCAATGAAGTGTGCG
GCAACTACCAATAGGTTATCTGGG -> CAACTACCAATAGGTTATCTGGGA
ACGACTCCTCTGCATATATCATCG -> CGACTCCTCTGCATATATCATCGG
GTGTAATGTACTAAGTCCAGCTAC -> TGTAATGTACTAAGTCCAGCTACG
TTCTCGGCCGTTGACGCCCGTTAT -> TCTCGGCCGTTGACGCCCGTTATC
CGATGATTTGGTATTTACGCCGCA -> GATGATTTGGTATTTACGCCGCAT
GTATTAAGCTATTGTTGAAGCCTA -> TATTAAGCTATTGTTGAAGCCTAC
TCATTTTACGTCGAATAGTTACGT -> CATTTTACGTCGAATAGTTACGTG
ATCGTCATTCCGTGAATTATCCGT -> TCGTCATTCCGTGAATTATCCGTA
CCATTTGAGGTGCCTGTAGTTCTA -> CATTTGAGGTGCCTGTAGTTCTAT
AGCAGGAGGCGGGCCGGAGGAGGC -> GCAGGAGGCGGGCCGGAGGAGGCA
TTGTTTTCGGCTGTCCTTCTAGGG -> TGTTTTCGGCTGTCCTTCTAGGGC
GGCGCCGTCGGTCACACGCCCGGT -> GCGCCGTCGGTCACACGCCCGGTG
TGCCCACTGCCAGTGGATCCGCGC -> GCCCACTGCCAGTGGATCCGCGCG
GCGCCAAAAGATGACCGACGGAGA -> CGCCAAAAGATGACCGACGGAGAA
CGGTGTGCTGTATTTGATGCACTG -> GGTGTGCTGTATTTGATGCACTGC
GTTGGTATCGATGATTTGGTATTT -> TTGGTATCGATGATTTGGTATTTA
GAGAGCATCCTCTAGGTAAACGGT -> AGAGCATCCTCTAGGTAAACGGTG
TCCAGGTAAAATGCCCTTAACCCA -> CCAGGTAAAATGCCCTTAACCCAT
CTGATACAGGTGCCAACTCGGGTG -> TGATACAGGTGCCAACTCGGGTGT
CTTATTACAGTGGCGCTCTGGGCG -> TTATTACAGTGGCGCTCTGGGCGT
GTTGTTTTCGGCTGTCCTTCTAGG -> TTGTTTTCGGCTGTCCTTCTAGGG
TGCCTAAACCAGGTGCGCATAATC -> GCCTAAACCAGGTGCGCATAATCC
CAGGATTGCCGATATGTTGCATAC -> AGGATTGCCGATATGTTGCATACG
CATGAAGTTGATCGGTATCATAAT -> ATGAAGTTGATCGGTATCATAATG
AAAAGATAGAGGTATCGAGTGTAA -> AAAGATAGAGGTATCGAGTGTAAT
TGCCCGTTGTTTTCGGCTGTCCTT -> GCCCGTTGTTTTCGGCTGTCCTTC
CAAGAATGCCCCGATGTAGCCCTT -> AAGAATGCCCCGATGTAGCCCTTC
AGATTCCAGCACCTCAATGAAGTG -> GATTCCAGCACCTCAATGAAGTGT
CGGAGGAGGCAGAGACCAGGATTG -> GGAGGAGGCAGAGACCAGGATTGC
CGAGCCCGCCTACCAGGCCTGTTG -> GAGCCCGCCTACCAGGCCTGTTGA
CTCTTTTTTTCTGTATCACGATGT -> TCTTTTTTTCTGTATCACGATGTG
TCAAGGCAGATTCCAGCACCTCAA -> CAAGGCAGATTCCAGCACCTCAAT
GACGACTCCTCTGCATATATCATC -> ACGACTCCTCTGCATATATCATCG
AGTGGCGCTCTGGGCGTCGAGAGC -> GTGGCGCTCTGGGCGTCGAGAGCA
TCCGTGAATTATCCGTAGTTCCTA -> CCGTGAATTATCCGTAGTTCCTAC
GTGTGTTTGCGGGGCTAAGGCTCG -> TGTGTTTGCGGGGCTAAGGCTCGT
CTAGGTAAACGGTGTCGGATACCC -> TAGGTAAACGGTGTCGGATACCCA
GTCGGTCACACGCCCGGTGTGCTG -> TCGGTCACACGCCCGGTGTGCTGT
CCCTTCTTACCCATTTGAGGTGCC -> CCTTCTTACCCATTTGAGGTGCCT
AGATGACCGACGGAGAAGTCTACT -> GATGACCGACGGAGAAGTCTACTA
AACTCGGGTGTGTTTGCGGGGCTA -> ACTCGGGTGTGTTTGCGGGGCTAA
TTGCGCCCGAATCTTATCTATGAT -> TGCGCCCGAATCTTATCTATGATC
CCTACGCTCATTTTACGTCGAATA -> CTACGCTCATTTTACGTCGAATAG
GCTGTTGGACATGTTGGTATCGAT -> CTGTTGGACATGTTGGTATCGATG
AAGGACTCCCGGGGGGAAGCCAGC -> AGGACTCCCGGGGGGAAGCCAGCC
CTCGTTAACAATCTTTGCGCCCGA -> TCGTTAACAATCTTTGCGCCCGAA
GGTATTCGCGTTGCCGATTCAAGG -> GTATTCGCGTTGCCGATTCAAGGC
CTTTGCGCCCGAATCTTATCTATG -> TTTGCGCCCGAATCTTATCTATGA
ATAAGGAAGCCACCAGCCTGACTG -> TAAGGAAGCCACCAGCCTGACTGC
ACAACTTGAAGAGGTCAGTGAAGA -> CAACTTGAAGAGGTCAGTGAAGAT
AAAGAAGACATGATATTGTGCCCG -> AAGAAGACATGATATTGTGCCCGG
CAGCTACGTGGCCGGTCAATTGTG -> AGCTACGTGGCCGGTCAATTGTGC
AGTGCTGGGCTTGCCTTTAGTGAT -> GTGCTGGGCTTGCCTTTAGTGATT
CCGGGGAACTGAGATAAAGAGGTA -> CGGGGAACTGAGATAAAGAGGTAA
AAGCCACCAGCCTGACTGCCCGTT -> AGCCACCAGCCTGACTGCCCGTTG
TGTCTTACTTACTAAGAACGCTGT -> GTCTTACTTACTAAGAACGCTGTT
GCGGAGAGTAGAGTTAAGTTGGCA -> CGGAGAGTAGAGTTAAGTTGGCAT
AGCGTCAAGGCTCGGTTCGTATGC -> GCGTCAAGGCTCGGTTCGTATGCC
TATGCCTCTTGCGCGACGTATTAA -> ATGCCTCTTGCGCGACGTATTAAG
GTGGCCGGTCAATTGTGCGGGCGA -> TGGCCGGTCAATTGTGCGGGCGAG
CCAGGATTGCCGATATGTTGCATA -> CAGGATTGCCGATATGTTGCATAC
AGAAGACATGATATTGTGCCCGGG -> GAAGACATGATATTGTGCCCGGGG
TTTAGTGATTCATTAAAGAAGACA -> TTAGTGATTCATTAAAGAAGACAT
GGGGAACTGAGATAAAGAGGTAAC -> GGGAACTGAGATAAAGAGGTAACA
TATCTTGCCGACTTTCCAGGTAAA -> ATCTTGCCGACTTTCCAGGTAAAA
CACCAAGAATGCCCCGATGTAGCC -> ACCAAGAATGCCCCGATGTAGCCC
CCCCGATGTAGCCCTTCTTTTGTT -> CCCGATGTAGCCCTTCTTTTGTTC
GCATCCTCTAGGTAAACGGTGTCG -> CATCCTCTAGGTAAACGGTGTCGG
TTACTCATTCTCGGCCGTTGACGC -> TACTCATTCTCGGCCGTTGACGCC
TTCCCGCTCTGCTTATTACAGTGG -> TCCCGCTCTGCTTATTACAGTGGC
CATGAGGGTAAAAGCGTCAAGGCT -> ATGAGGGTAAAAGCGTCAAGGCTC
GGCAGAGACCAGGATTGCCGATAT -> GCAGAGACCAGGATTGCCGATATG
ATGATCGTCTTATTTCCAGTGACA -> TGATCGTCTTATTTCCAGTGACAC
TTTTTTCTGTATCACGATGTGCGC -> TTTTTCTGTATCACGATGTGCGCG
TTGCGGGGCTAAGGCTCGTTAACA -> TGCGGGGCTAAGGCTCGTTAACAA
CCACGGACGTGACAACTTGAAGAG -> CACGGACGTGACAACTTGAAGAGG
GGCCGGAGGAGGCAGAGACCAGGA -> GCCGGAGGAGGCAGAGACCAGGAT
GCACCTCAATGAAGTGTGCGTGAC -> CACCTCAATGAAGTGTGCGTGACT
TACTAAAGTATTGAGGTGGCTTCC -> ACTAAAGTATTGAGGTGGCTTCCC
CTGAGGTGCGGGCAACTACCAATA -> TGAGGTGCGGGCAACTACCAATAG
CCGGTCAATTGTGCGGGCGAGCAC -> CGGTCAATTGTGCGGGCGAGCACC
ACATGTTGGTATCGATGATTTGGT -> CATGTTGGTATCGATGATTTGGTA
TGCGGGCGAGCACCGGACTGATAT -> GCGGGCGAGCACCGGACTGATATT
TGCGGGGCTAAGGCTCGTTAACAA -> GCGGGGCTAAGGCTCGTTAACAAT
AGTGTGCGTGACTTCAAAAGGACT -> GTGTGCGTGACTTCAAAAGGACTC
GGACATGTTGGTATCGATGATTTG -> GACATGTTGGTATCGATGATTTGG
ACCCATTTCGCCTGTGAGGTAGCT -> CCCATTTCGCCTGTGAGGTAGCTC
TGCGCCCGAATCTTATCTATGATC -> GCGCCCGAATCTTATCTATGATCG
ACCAGGATTGCCGATATGTTGCAT -> CCAGGATTGCCGATATGTTGCATA
GAGGTCAGTGAAGATGCAATCATG -> AGGTCAGTGAAGATGCAATCATGT
CACGCCAAGCGGGTGTTCTATCTT -> ACGCCAAGCGGGTGTTCTATCTTG
ACGCCCGTTATCAGTGCATGAGGG -> CGCCCGTTATCAGTGCATGAGGGT
TGTATCACGATGTGCGCGTTGTTC -> GTATCACGATGTGCGCGTTGTTCA
GGGGCAATGCCTAAACCAGGTGCG -> GGGCAATGCCTAAACCAGGTGCGC
GCTGGTTAGAGTGCTGGGCTTGCC -> CTGGTTAGAGTGCTGGGCTTGCCT
GGGAAGAAGGCATGATAATCTGGG -> GGAAGAAGGCATGATAATCTGGGC
AGGTAGCTCAACTCGCTGAAAACA -> GGTAGCTCAACTCGCTGAAAACAT
CGTGACTTCAAAAGGACTCCCGGG -> GTGACTTCAAAAGGACTCCCGGGG
TTTACGCCGCATACTAGTCGTGAT -> TTACGCCGCATACTAGTCGTGATG
TGTGCGTGACTTCAAAAGGACTCC -> GTGCGTGACTTCAAAAGGACTCCC
ATGATAATCTGGGCGACTAAGAAT -> TGATAATCTGGGCGACTAAGAATG
TTTCGGCTGTCCTTCTAGGGCCCC -> TTCGGCTGTCCTTCTAGGGCCCCA
TGCAGCCTCTTTTTTTCTGTATCA -> GCAGCCTCTTTTTTTCTGTATCAC
CTCGACTCGTTCTGTCTATTACAA -> TCGACTCGTTCTGTCTATTACAAG
GCGGGTGTTCTATCTTGCCGACTT -> CGGGTGTTCTATCTTGCCGACTTT
GCCCGGGGAACTGAGATAAAGAGG -> CCCGGGGAACTGAGATAAAGAGGT
ATTGCAGGGAAGAAGGCATGATAA -> TTGCAGGGAAGAAGGCATGATAAT
ACCAGCCTGACTGCCCGTTGTTTT -> CCAGCCTGACTGCCCGTTGTTTTC
TGCCCCGATGTAGCCCTTCTTTTG -> GCCCCGATGTAGCCCTTCTTTTGT
TCACGATGTGCGCGTTGTTCAATA -> CACGATGTGCGCGTTGTTCAATAT
TATTCGACGACTCCTCTGCATATA -> ATTCGACGACTCCTCTGCATATAT
CGAGCACCGGACTGATATTGCAGG -> GAGCACCGGACTGATATTGCAGGG
ACTAAGAATGACTCGACTCGTTCT -> CTAAGAATGACTCGACTCGTTCTG
AGGGTAAAAGCGTCAAGGCTCGGT -> GGGTAAAAGCGTCAAGGCTCGGTT
TACGTCGAATAGTTACGTGGCTGA -> ACGTCGAATAGTTACGTGGCTGAT
AGGTAAAATGCCCTTAACCCATTT -> GGTAAAATGCCCTTAACCCATTTC
TTGGTATTTACGCCGCATACTAGT -> TGGTATTTACGCCGCATACTAGTC
TTGTCTGTGCCCACTGCCAGTGGA -> TGTCTGTGCCCACTGCCAGTGGAT
GTGACTTCAAAAGGACTCCCGGGG -> TGACTTCAAAAGGACTCCCGGGGG
GAGATAAAGAGGTAACAAACGAGA -> AGATAAAGAGGTAACAAACGAGAC
GCTCGTTAACAATCTTTGCGCCCG -> CTCGTTAACAATCTTTGCGCCCGA
CGAAATTGCAGCCTCTTTTTTTCT -> GAAATTGCAGCCTCTTTTTTTCTG
CCTTCTTACCCATTTGAGGTGCCT -> CTTCTTACCCATTTGAGGTGCCTG
GAGGCAGAGACCAGGATTGCCGAT -> AGGCAGAGACCAGGATTGCCGATA
TAATCTGGGCGACTAAGAATGACT -> AATCTGGGCGACTAAGAATGACTC
GCTCTGCTTATTACAGTGGCGCTC -> CTCTGCTTATTACAGTGGCGCTCT
CTGCCCGTTGTTTTCGGCTGTCCT -> TGCCCGTTGTTTTCGGCTGTCCTT
TGAGGTGCCTGTAGTTCTATTCGA -> GAGGTGCCTGTAGTTCTATTCGAC
ATAATCTGGGCGACTAAGAATGAC -> TAATCTGGGCGACTAAGAATGACT
AAGTGTGCGTGACTTCAAAAGGAC -> AGTGTGCGTGACTTCAAAAGGACT
AGCCACCAGCCTGACTGCCCGTTG -> GCCACCAGCCTGACTGCCCGTTGT
CAAGGCTCGGTTCGTATGCCTCTT -> AAGGCTCGGTTCGTATGCCTCTTG
GAAGTCTACTAAAGTATTGAGGTG -> AAGTCTACTAAAGTATTGAGGTGG
CAACTCGCTGAAAACATATTACTC -> AACTCGCTGAAAACATATTACTCA
ATCGAACTCTCTATCGTCATTCCG -> TCGAACTCTCTATCGTCATTCCGT
GTTGAAGCCTACCCGTAAGCCTGG -> TTGAAGCCTACCCGTAAGCCTGGG
ATGCTGTGCGCCAAAAGATGACCG -> TGCTGTGCGCCAAAAGATGACCGA
AGGTGCGGGCAACTACCAATAGGT -> GGTGCGGGCAACTACCAATAGGTT
TATCATCGGGCTGCCATCGAAGCA -> ATCATCGGGCTGCCATCGAAGCAG
GCCTGTTGATTGTAGACGGTTCTG -> CCTGTTGATTGTAGACGGTTCTGG
GGTGCGGGCAACTACCAATAGGTT -> GTGCGGGCAACTACCAATAGGTTA
AATCCGGCGCCGTCGGTCACACGC -> ATCCGGCGCCGTCGGTCACACGCC
AGAATGACTCGACTCGTTCTGTCT -> GAATGACTCGACTCGTTCTGTCTA
TTGTGCCCGGGGAACTGAGATAAA -> TGTGCCCGGGGAACTGAGATAAAG
TCTTATCTATGATCGTCTTATTTC -> CTTATCTATGATCGTCTTATTTCC
GGGCGACTAAGAATGACTCGACTC -> GGCGACTAAGAATGACTCGACTCG
CTCAATGAAGTGTGCGTGACTTCA -> TCAATGAAGTGTGCGTGACTTCAA
GGGCCGGAGGAGGCAGAGACCAGG -> GGCCGGAGGAGGCAGAGACCAGGA
CTTTAGTGATTCATTAAAGAAGAC -> TTTAGTGATTCATTAAAGAAGACA
GAGAAGTCTACTAAAGTATTGAGG -> AGAAGTCTACTAAAGTATTGAGGT
CGTCTTATTTCCAGTGACACTATC -> GTCTTATTTCCAGTGACACTATCC
TCCCGCTCTGCTTATTACAGTGGC -> CCCGCTCTGCTTATTACAGTGGCG
CTGTATTTGATGCACTGCTCGTTC -> TGTATTTGATGCACTGCTCGTTCA
CAGCCACCCATAACTCTAACCTGA -> AGCCACCCATAACTCTAACCTGAG
CAGCACCTCAATGAAGTGTGCGTG -> AGCACCTCAATGAAGTGTGCGTGA
TGCGTGACTTCAAAAGGACTCCCG -> GCGTGACTTCAAAAGGACTCCCGG
TCATGTCTAATTGCCCCAAAAGAT -> CATGTCTAATTGCCCCAAAAGATA
ATAATGCTGTGCGCCAAAAGATGA -> TAATGCTGTGCGCCAAAAGATGAC
TTATTTCCAGTGACACTATCCCGA -> TATTTCCAGTGACACTATCCCGAA
CGAATCTTATCTATGATCGTCTTA -> GAATCTTATCTATGATCGTCTTAT
GTCCACGTTAGGTATTCGCGTTGC -> TCCACGTTAGGTATTCGCGTTGCC
GGGGGAAGCCAGCCACCCATAACT -> GGGGAAGCCAGCCACCCATAACTC
ATATTCAGCTCGAATTGTCTGTGC -> TATTCAGCTCGAATTGTCTGTGCC
ACAAACGAGACGGAGTAGCACGAT -> CAAACGAGACGGAGTAGCACGATA
ATCATCGGGCTGCCATCGAAGCAG -> TCATCGGGCTGCCATCGAAGCAGG
AAGCGGGTGTTCTATCTTGCCGAC -> AGCGGGTGTTCTATCTTGCCGACT
GAACTGAGATAAAGAGGTAACAAA -> AACTGAGATAAAGAGGTAACAAAC
TGAGGTGGCTTCCCCCCTTCTTAC -> GAGGTGGCTTCCCCCCTTCTTACC
ACAATCGAACTCTCTATCGTCATT -> CAATCGAACTCTCTATCGTCATTC
AGCCTCTTTTTTTCTGTATCACGA -> GCCTCTTTTTTTCTGTATCACGAT
GGAATGCTGGTTAGAGTGCTGGGC -> GAATGCTGGTTAGAGTGCTGGGCT
TATTGTGCCCGGGGAACTGAGATA -> ATTGTGCCCGGGGAACTGAGATAA
GTAATGTACTAAGTCCAGCTACGT -> TAATGTACTAAGTCCAGCTACGTG
GATTGATAAGCCGCGGAGAGTAGA -> ATTGATAAGCCGCGGAGAGTAGAG
CTGCTTATTACAGTGGCGCTCTGG -> TGCTTATTACAGTGGCGCTCTGGG
CAATATTCAGCTCGAATTGTCTGT -> AATATTCAGCTCGAATTGTCTGTG
TATTCAGCTCGAATTGTCTGTGCC -> ATTCAGCTCGAATTGTCTGTGCCC
ATCCTCTAGGTAAACGGTGTCGGA -> TCCTCTAGGTAAACGGTGTCGGAT
GCCCGCCTACCAGGCCTGTTGATT -> CCCGCCTACCAGGCCTGTTGATTG
ATGTTGGTATCGATGATTTGGTAT -> TGTTGGTATCGATGATTTGGTATT
GGCATGAAGTTGATCGGTATCATA -> GCATGAAGTTGATCGGTATCATAA
ACTAGTCGTGATGCGGTACGGAAA -> CTAGTCGTGATGCGGTACGGAAAT
GTTGCCGATTCAAGGCAGATTCCA -> TTGCCGATTCAAGGCAGATTCCAG
CGGTTCGTATGCCTCTTGCGCGAC -> GGTTCGTATGCCTCTTGCGCGACG
CACCCATAACTCTAACCTGAGGTG -> ACCCATAACTCTAACCTGAGGTGC
AACTCTAACCTGAGGTGCGGGCAA -> ACTCTAACCTGAGGTGCGGGCAAC
CTACGTGGCCGGTCAATTGTGCGG -> TACGTGGCCGGTCAATTGTGCGGG
ATCAGTGCATGAGGGTAAAAGCGT -> TCAGTGCATGAGGGTAAAAGCGTC
TAGACGGTTCTGGTGGATGGAAGC -> AGACGGTTCTGGTGGATGGAAGCA
AAGGCTCGGTTCGTATGCCTCTTG -> AGGCTCGGTTCGTATGCCTCTTGC
TGGCGCTCTGGGCGTCGAGAGCAT -> GGCGCTCTGGGCGTCGAGAGCATC
CAGAGACCAGGATTGCCGATATGT -> AGAGACCAGGATTGCCGATATGTT
AAAGATGACCGACGGAGAAGTCTA -> AAGATGACCGACGGAGAAGTCTAC
GCCTCTTGCGCGACGTATTAAGCT -> CCTCTTGCGCGACGTATTAAGCTA
TACAGGTGCCAACTCGGGTGTGTT -> ACAGGTGCCAACTCGGGTGTGTTT
TCGGGTGTGTTTGCGGGGCTAAGG -> CGGGTGTGTTTGCGGGGCTAAGGC
GGCGAGCACCGGACTGATATTGCA -> GCGAGCACCGGACTGATATTGCAG
GAAGGCATGATAATCTGGGCGACT -> AAGGCATGATAATCTGGGCGACTA
GTATTCGCGTTGCCGATTCAAGGC -> TATTCGCGTTGCCGATTCAAGGCA
GCCCCAAAAGATAGAGGTATCGAG -> CCCCAAAAGATAGAGGTATCGAGT
CCGACTTTCCAGGTAAAATGCCCT -> CGACTTTCCAGGTAAAATGCCCTT
AATCATGTCTTACTTACTAAGAAC -> ATCATGTCTTACTTACTAAGAACG
AAGCCAGCCACCCATAACTCTAAC -> AGCCAGCCACCCATAACTCTAACC
CTTTCCAGGTAAAATGCCCTTAAC -> TTTCCAGGTAAAATGCCCTTAACC
GGCGTCGAGAGCATCCTCTAGGTA -> GCGTCGAGAGCATCCTCTAGGTAA
GATGACCGACGGAGAAGTCTACTA -> ATGACCGACGGAGAAGTCTACTAA
TAGTCACGCCAAGCGGGTGTTCTA -> AGTCACGCCAAGCGGGTGTTCTAT
CGGAGAAGTCTACTAAAGTATTGA -> GGAGAAGTCTACTAAAGTATTGAG
GAAAACATATTACTCATTCTCGGC -> AAAACATATTACTCATTCTCGGCC
GTGTGCTGTATTTGATGCACTGCT -> TGTGCTGTATTTGATGCACTGCTC
AGGTATTCGCGTTGCCGATTCAAG -> GGTATTCGCGTTGCCGATTCAAGG
GCGTCGAGAGCATCCTCTAGGTAA -> CGTCGAGAGCATCCTCTAGGTAAA
CTTAACCCATTTCGCCTGTGAGGT -> TTAACCCATTTCGCCTGTGAGGTA
AACAATCTTTGCGCCCGAATCTTA -> ACAATCTTTGCGCCCGAATCTTAT
ACAAGCGTGCTTATCCACGGACGT -> CAAGCGTGCTTATCCACGGACGTG
CTTATTTCCAGTGACACTATCCCG -> TTATTTCCAGTGACACTATCCCGA
CGCTCTGGGCGTCGAGAGCATCCT -> GCTCTGGGCGTCGAGAGCATCCTC
TATCTATGATCGTCTTATTTCCAG -> ATCTATGATCGTCTTATTTCCAGT
AGTCCAGCTACGTGGCCGGTCAAT -> GTCCAGCTACGTGGCCGGTCAATT
ACATATTACTCATTCTCGGCCGTT -> CATATTACTCATTCTCGGCCGTTG
ATTTGAGGTGCCTGTAGTTCTATT -> TTTGAGGTGCCTGTAGTTCTATTC
AATTATCCGTAGTTCCTACGCTCA -> ATTATCCGTAGTTCCTACGCTCAT
GCGCCGTCGGTCACACGCCCGGTG -> CGCCGTCGGTCACACGCCCGGTGT
GGGAAGCCAGCCACCCATAACTCT -> GGAAGCCAGCCACCCATAACTCTA
AGGTTATCTGGGAGAATCTTCCAC -> GGTTATCTGGGAGAATCTTCCACC
TATCGTCATTCCGTGAATTATCCG -> ATCGTCATTCCGTGAATTATCCGT
CTCGTTCTGTCTATTACAAGCGTG -> TCGTTCTGTCTATTACAAGCGTGC
GCCTGGGGATTGATAAGCCGCGGA -> CCTGGGGATTGATAAGCCGCGGAG
TGCCTGTAGTTCTATTCGACGACT -> GCCTGTAGTTCTATTCGACGACTC
GATAATCTGGGCGACTAAGAATGA -> ATAATCTGGGCGACTAAGAATGAC
ATATCGAGCCCGCCTACCAGGCCT -> TATCGAGCCCGCCTACCAGGCCTG
GAGGTAACAAACGAGACGGAGTAG -> AGGTAACAAACGAGACGGAGTAGC
CCAAAAGATGACCGACGGAGAAGT -> CAAAAGATGACCGACGGAGAAGTC
ACTGAGATAAAGAGGTAACAAACG -> CTGAGATAAAGAGGTAACAAACGA
CAGGTGCCAACTCGGGTGTGTTTG -> AGGTGCCAACTCGGGTGTGTTTGC
GTAAAAGCGTCAAGGCTCGGTTCG -> TAAAAGCGTCAAGGCTCGGTTCGT
ACAATCTTTGCGCCCGAATCTTAT -> CAATCTTTGCGCCCGAATCTTATC
GTTGACGCCCGTTATCAGTGCATG -> TTGACGCCCGTTATCAGTGCATGA
CTATCTTGCCGACTTTCCAGGTAA -> TATCTTGCCGACTTTCCAGGTAAA
CCGACGGAGAAGTCTACTAAAGTA -> CGACGGAGAAGTCTACTAAAGTAT
CGGGTGTTCTATCTTGCCGACTTT -> GGGTGTTCTATCTTGCCGACTTTC
CTGATATTGCAGGGAAGAAGGCAT -> TGATATTGCAGGGAAGAAGGCATG
CCCGTTATCAGTGCATGAGGGTAA -> CCGTTATCAGTGCATGAGGGTAAA
TGACCGACGGAGAAGTCTACTAAA -> GACCGACGGAGAAGTCTACTAAAG
ATATGCACCTCGTCACAATCGAAC -> TATGCACCTCGTCACAATCGAACT
GCAGAGACCAGGATTGCCGATATG -> CAGAGACCAGGATTGCCGATATGT
ACTAAGAACGCTGTTGGACATGTT -> CTAAGAACGCTGTTGGACATGTTG
TGCACTGCTCGTTCATGTCTAATT -> GCACTGCTCGTTCATGTCTAATTG
GTTAGAGTGCTGGGCTTGCCTTTA -> TTAGAGTGCTGGGCTTGCCTTTAG
ATCCGGCGCCGTCGGTCACACGCC -> TCCGGCGCCGTCGGTCACACGCCC
GGGCAATGCCTAAACCAGGTGCGC -> GGCAATGCCTAAACCAGGTGCGCA
CTGGTGGATGGAAGCATAAGGAAG -> TGGTGGATGGAAGCATAAGGAAGC
GTAAGCCTGGGGATTGATAAGCCG -> TAAGCCTGGGGATTGATAAGCCGC
TGTGCGCCAAAAGATGACCGACGG -> GTGCGCCAAAAGATGACCGACGGA
ATAAGCCGCGGAGAGTAGAGTTAA -> TAAGCCGCGGAGAGTAGAGTTAAG
AAGCGTGCTTATCCACGGACGTGA -> AGCGTGCTTATCCACGGACGTGAC
ACCCATAACTCTAACCTGAGGTGC -> CCCATAACTCTAACCTGAGGTGCG
CTAGTCGTGATGCGGTACGGAAAT -> TAGTCGTGATGCGGTACGGAAATG
CTGCCAGTGGATCCGCGCGGTACC -> TGCCAGTGGATCCGCGCGGTACCG
ATGTCTTACTTACTAAGAACGCTG -> TGTCTTACTTACTAAGAACGCTGT
ACTCATTCTCGGCCGTTGACGCCC -> CTCATTCTCGGCCGTTGACGCCCG
GGAAGAAGGCATGATAATCTGGGC -> GAAGAAGGCATGATAATCTGGGCG
TGTTCCCGCTCTGCTTATTACAGT -> GTTCCCGCTCTGCTTATTACAGTG
GCCTGTAGTTCTATTCGACGACTC -> CCTGTAGTTCTATTCGACGACTCC
TGTCTGTGCCCACTGCCAGTGGAT -> GTCTGTGCCCACTGCCAGTGGATC
GAGCATCCTCTAGGTAAACGGTGT -> AGCATCCTCTAGGTAAACGGTGTC
ATGAGACGCGATATCGAGCCCGCC -> TGAGACGCGATATCGAGCCCGCCT
CTAAGGCTCGTTAACAATCTTTGC -> TAAGGCTCGTTAACAATCTTTGCG
CACGTTAGGTATTCGCGTTGCCGA -> ACGTTAGGTATTCGCGTTGCCGAT
CTGCATATATCATCGGGCTGCCAT -> TGCATATATCATCGGGCTGCCATC
CTTGAAGAGGTCAGTGAAGATGCA -> TTGAAGAGGTCAGTGAAGATGCAA
CTGTGCGCCAAAAGATGACCGACG -> TGTGCGCCAAAAGATGACCGACGG
CGGTTCTGGTGGATGGAAGCATAA -> GGTTCTGGTGGATGGAAGCATAAG
GACATGTTGGTATCGATGATTTGG -> ACATGTTGGTATCGATGATTTGGT
GCTCTGGGCGTCGAGAGCATCCTC -> CTCTGGGCGTCGAGAGCATCCTCT
TCAACTCGCTGAAAACATATTACT -> CAACTCGCTGAAAACATATTACTC
ATCCACGGACGTGACAACTTGAAG -> TCCACGGACGTGACAACTTGAAGA
CATAATCCGGCGCCGTCGGTCACA -> ATAATCCGGCGCCGTCGGTCACAC
TGTGCTGTATTTGATGCACTGCTC -> GTGCTGTATTTGATGCACTGCTCG
GTCGGATACCCATCTCTGGGGCAA -> TCGGATACCCATCTCTGGGGCAAT
GACTAAGAATGACTCGACTCGTTC -> ACTAAGAATGACTCGACTCGTTCT
CATCCTCTAGGTAAACGGTGTCGG -> ATCCTCTAGGTAAACGGTGTCGGA
AATGCCTAAACCAGGTGCGCATAA -> ATGCCTAAACCAGGTGCGCATAAT
TTTGCGCCCGAATCTTATCTATGA -> TTGCGCCCGAATCTTATCTATGAT
CCCGCTCTGCTTATTACAGTGGCG -> CCGCTCTGCTTATTACAGTGGCGC
GCTGTATTTGATGCACTGCTCGTT -> CTGTATTTGATGCACTGCTCGTTC
TGTCCTTCTAGGGCCCCAGTGCAT -> GTCCTTCTAGGGCCCCAGTGCATT
GACTTTCCAGGTAAAATGCCCTTA -> ACTTTCCAGGTAAAATGCCCTTAA
GCACTGCTCGTTCATGTCTAATTG -> CACTGCTCGTTCATGTCTAATTGC
GTATCACGATGTGCGCGTTGTTCA -> TATCACGATGTGCGCGTTGTTCAA
TCGAAGCAGGAGGCGGGCCGGAGG -> CGAAGCAGGAGGCGGGCCGGAGGA
CGGTCAATTGTGCGGGCGAGCACC -> GGTCAATTGTGCGGGCGAGCACCG
GCCTGTGAGGTAGCTCAACTCGCT -> CCTGTGAGGTAGCTCAACTCGCTG
TGACTGCCCGTTGTTTTCGGCTGT -> GACTGCCCGTTGTTTTCGGCTGTC
GTGCCCACTGCCAGTGGATCCGCG -> TGCCCACTGCCAGTGGATCCGCGC
GGTTCGTATGCCTCTTGCGCGACG -> GTTCGTATGCCTCTTGCGCGACGT
CAGTGACACTATCCCGAAATTGCA -> AGTGACACTATCCCGAAATTGCAG
GTATCATAATGCTGTGCGCCAAAA -> TATCATAATGCTGTGCGCCAAAAG
CAGTGCATGAGGGTAAAAGCGTCA -> AGTGCATGAGGGTAAAAGCGTCAA
CCATCTCTGGGGCAATGCCTAAAC -> CATCTCTGGGGCAATGCCTAAACC
CTGCTCGTTCATGTCTAATTGCCC -> TGCTCGTTCATGTCTAATTGCCCC
TTCAAAAGGACTCCCGGGGGGAAG -> TCAAAAGGACTCCCGGGGGGAAGC
CTAACCTGAGGTGCGGGCAACTAC -> TAACCTGAGGTGCGGGCAACTACC
TAAAATGCCCTTAACCCATTTCGC -> AAAATGCCCTTAACCCATTTCGCC
CCCGTTGTTTTCGGCTGTCCTTCT -> CCGTTGTTTTCGGCTGTCCTTCTA
CGCCAAAAGATGACCGACGGAGAA -> GCCAAAAGATGACCGACGGAGAAG
CTACCAATAGGTTATCTGGGAGAA -> TACCAATAGGTTATCTGGGAGAAT
CCGGCGCCGTCGGTCACACGCCCG -> CGGCGCCGTCGGTCACACGCCCGG
GCCCGTTGTTTTCGGCTGTCCTTC -> CCCGTTGTTTTCGGCTGTCCTTCT
TAAAGAGGTAACAAACGAGACGGA -> AAAGAGGTAACAAACGAGACGGAG
AGACGGTTCTGGTGGATGGAAGCA -> GACGGTTCTGGTGGATGGAAGCAT
CTGTCCTTCTAGGGCCCCAGTGCA -> TGTCCTTCTAGGGCCCCAGTGCAT
CCGGACTGATATTGCAGGGAAGAA -> CGGACTGATATTGCAGGGAAGAAG
TATCGAGCCCGCCTACCAGGCCTG -> ATCGAGCCCGCCTACCAGGCCTGT
GCCACCAGCCTGACTGCCCGTTGT -> CCACCAGCCTGACTGCCCGTTGTT
GAGTAGAGTTAAGTTGGCATGAAG -> AGTAGAGTTAAGTTGGCATGAAGT
GGACTCCCGGGGGGAAGCCAGCCA -> GACTCCCGGGGGGAAGCCAGCCAC
TGTTTGCGGGGCTAAGGCTCGTTA -> GTTTGCGGGGCTAAGGCTCGTTAA
TTCTTTTGTTCCCGCTCTGCTTAT -> TCTTTTGTTCCCGCTCTGCTTATT
ATTGATAAGCCGCGGAGAGTAGAG -> TTGATAAGCCGCGGAGAGTAGAGT
AGGTGCCAACTCGGGTGTGTTTGC -> GGTGCCAACTCGGGTGTGTTTGCG
GTCTATTACAAGCGTGCTTATCCA -> TCTATTACAAGCGTGCTTATCCAC
TACGCCGCATACTAGTCGTGATGC -> ACGCCGCATACTAGTCGTGATGCG
CTCGGCCGTTGACGCCCGTTATCA -> TCGGCCGTTGACGCCCGTTATCAG
CCGTTATCAGTGCATGAGGGTAAA -> CGTTATCAGTGCATGAGGGTAAAA
GTGGCTGATACAGGTGCCAACTCG -> TGGCTGATACAGGTGCCAACTCGG
ACTCTAACCTGAGGTGCGGGCAAC -> CTCTAACCTGAGGTGCGGGCAACT
TCTTCCACCAAGAATGCCCCGATG -> CTTCCACCAAGAATGCCCCGATGT
TGTGAGGTAGCTCAACTCGCTGAA -> GTGAGGTAGCTCAACTCGCTGAAA
ATTGTTGAAGCCTACCCGTAAGCC -> TTGTTGAAGCCTACCCGTAAGCCT
AACTACCAATAGGTTATCTGGGAG -> ACTACCAATAGGTTATCTGGGAGA
CAGGTGCGCATAATCCGGCGCCGT -> AGGTGCGCATAATCCGGCGCCGTC
GTATCGAGTGTAATGTACTAAGTC -> TATCGAGTGTAATGTACTAAGTCC
GCTTGCCTTTAGTGATTCATTAAA -> CTTGCCTTTAGTGATTCATTAAAG
GACGGAGAAGTCTACTAAAGTATT -> ACGGAGAAGTCTACTAAAGTATTG
GGTTCTGGTGGATGGAAGCATAAG -> GTTCTGGTGGATGGAAGCATAAGG
TGTGCGGGCGAGCACCGGACTGAT -> GTGCGGGCGAGCACCGGACTGATA
GGCTGCCATCGAAGCAGGAGGCGG -> GCTGCCATCGAAGCAGGAGGCGGG
ACCTGAGGTGCGGGCAACTACCAA -> CCTGAGGTGCGGGCAACTACCAAT
TCGGCTGTCCTTCTAGGGCCCCAG -> CGGCTGTCCTTCTAGGGCCCCAGT
CCTACCAGGCCTGTTGATTGTAGA -> CTACCAGGCCTGTTGATTGTAGAC
GGGGGGAAGCCAGCCACCCATAAC -> GGGGGAAGCCAGCCACCCATAACT
GATGCGGTACGGAAATGAGACGCG -> ATGCGGTACGGAAATGAGACGCGA
TGCCGACTTTCCAGGTAAAATGCC -> GCCGACTTTCCAGGTAAAATGCCC
CATTTCGCCTGTGAGGTAGCTCAA -> ATTTCGCCTGTGAGGTAGCTCAAC
CGATTCAAGGCAGATTCCAGCACC -> GATTCAAGGCAGATTCCAGCACCT
TGATTCATTAAAGAAGACATGATA -> GATTCATTAAAGAAGACATGATAT
ATTTCGCCTGTGAGGTAGCTCAAC -> TTTCGCCTGTGAGGTAGCTCAACT
TGCCGATTCAAGGCAGATTCCAGC -> GCCGATTCAAGGCAGATTCCAGCA
TTTTTTTCTGTATCACGATGTGCG -> TTTTTTCTGTATCACGATGTGCGC
ATTCGCGTTGCCGATTCAAGGCAG -> TTCGCGTTGCCGATTCAAGGCAGA
GATATGCACCTCGTCACAATCGAA -> ATATGCACCTCGTCACAATCGAAC
CAATGCCTAAACCAGGTGCGCATA -> AATGCCTAAACCAGGTGCGCATAA
CCTAAACCAGGTGCGCATAATCCG -> CTAAACCAGGTGCGCATAATCCGG
CCTTCTTTTGTTCCCGCTCTGCTT -> CTTCTTTTGTTCCCGCTCTGCTTA
TATTGAGGTGGCTTCCCCCCTTCT -> ATTGAGGTGGCTTCCCCCCTTCTT
CGCCGCATACTAGTCGTGATGCGG -> GCCGCATACTAGTCGTGATGCGGT
GATTCAAGGCAGATTCCAGCACCT -> ATTCAAGGCAGATTCCAGCACCTC
GCCCTTAACCCATTTCGCCTGTGA -> CCCTTAACCCATTTCGCCTGTGAG
AGGAAGCCACCAGCCTGACTGCCC -> GGAAGCCACCAGCCTGACTGCCCG
GGCGGGCCGGAGGAGGCAGAGACC -> GCGGGCCGGAGGAGGCAGAGACCA
GCGCCCGAATCTTATCTATGATCG -> CGCCCGAATCTTATCTATGATCGT
GACGTATTAAGCTATTGTTGAAGC -> ACGTATTAAGCTATTGTTGAAGCC
ATTTGGTATTTACGCCGCATACTA -> TTTGGTATTTACGCCGCATACTAG
TTGGCATGAAGTTGATCGGTATCA -> TGGCATGAAGTTGATCGGTATCAT
CTCTAGGTAAACGGTGTCGGATAC -> TCTAGGTAAACGGTGTCGGATACC
TTATCCACGGACGTGACAACTTGA -> TATCCACGGACGTGACAACTTGAA
TGCTCGTTCATGTCTAATTGCCCC -> GCTCGTTCATGTCTAATTGCCCCA
CTTACCCATTTGAGGTGCCTGTAG -> TTACCCATTTGAGGTGCCTGTAGT
CCCTTCTTTTGTTCCCGCTCTGCT -> CCTTCTTTTGTTCCCGCTCTGCTT
ACTATCCCGAAATTGCAGCCTCTT -> CTATCCCGAAATTGCAGCCTCTTT
AGACGGAGTAGCACGATATGCACC -> GACGGAGTAGCACGATATGCACCT
TAACAAACGAGACGGAGTAGCACG -> AACAAACGAGACGGAGTAGCACGA
ATCCCGAAATTGCAGCCTCTTTTT -> TCCCGAAATTGCAGCCTCTTTTTT
ACTAAGTCCAGCTACGTGGCCGGT -> CTAAGTCCAGCTACGTGGCCGGTC
TTCTGGTGGATGGAAGCATAAGGA -> TCTGGTGGATGGAAGCATAAGGAA
CGAAGCAGGAGGCGGGCCGGAGGA -> GAAGCAGGAGGCGGGCCGGAGGAG
TATCGAGTGTAATGTACTAAGTCC -> ATCGAGTGTAATGTACTAAGTCCA
AAAATGCCCTTAACCCATTTCGCC -> AAATGCCCTTAACCCATTTCGCCT
TCTGCATATATCATCGGGCTGCCA -> CTGCATATATCATCGGGCTGCCAT
TCGTCACAATCGAACTCTCTATCG -> CGTCACAATCGAACTCTCTATCGT
GCCGCATACTAGTCGTGATGCGGT -> CCGCATACTAGTCGTGATGCGGTA
TACGCTCATTTTACGTCGAATAGT -> ACGCTCATTTTACGTCGAATAGTT
TCTAATTGCCCCAAAAGATAGAGG -> CTAATTGCCCCAAAAGATAGAGGT
GCGCATAATCCGGCGCCGTCGGTC -> CGCATAATCCGGCGCCGTCGGTCA
ATATTGCAGGGAAGAAGGCATGAT -> TATTGCAGGGAAGAAGGCATGATA
CTATTACAAGCGTGCTTATCCACG -> TATTACAAGCGTGCTTATCCACGG
TAAGGCTCGTTAACAATCTTTGCG -> AAGGCTCGTTAACAATCTTTGCGC
CGCTGTTGGACATGTTGGTATCGA -> GCTGTTGGACATGTTGGTATCGAT
TGAGACGCGATATCGAGCCCGCCT -> GAGACGCGATATCGAGCCCGCCTA
TCGGTATCATAATGCTGTGCGCCA -> CGGTATCATAATGCTGTGCGCCAA
GACTCCTCTGCATATATCATCGGG -> ACTCCTCTGCATATATCATCGGGC
TGCTGTATTTGATGCACTGCTCGT -> GCTGTATTTGATGCACTGCTCGTT
TCATGTCTTACTTACTAAGAACGC -> CATGTCTTACTTACTAAGAACGCT
TGTGCGCGTTGTTCAATATTCAGC -> GTGCGCGTTGTTCAATATTCAGCT
TGATATTGTGCCCGGGGAACTGAG -> GATATTGTGCCCGGGGAACTGAGA
ACGCGATATCGAGCCCGCCTACCA -> CGCGATATCGAGCCCGCCTACCAG
TGCGCGACGTATTAAGCTATTGTT -> GCGCGACGTATTAAGCTATTGTTG
CGGCGCCGTCGGTCACACGCCCGG -> GGCGCCGTCGGTCACACGCCCGGT
GGTCAATTGTGCGGGCGAGCACCG -> GTCAATTGTGCGGGCGAGCACCGG
TGGTGGATGGAAGCATAAGGAAGC -> GGTGGATGGAAGCATAAGGAAGCC
TGCGCATAATCCGGCGCCGTCGGT -> GCGCATAATCCGGCGCCGTCGGTC
ATGTTGCATACGAACCCGCCAGGA -> TGTTGCATACGAACCCGCCAGGAA
GACCAGGATTGCCGATATGTTGCA -> ACCAGGATTGCCGATATGTTGCAT
TCGAATAGTTACGTGGCTGATACA -> CGAATAGTTACGTGGCTGATACAG
ATTGAGGTGGCTTCCCCCCTTCTT -> TTGAGGTGGCTTCCCCCCTTCTTA
AACCCATTTCGCCTGTGAGGTAGC -> ACCCATTTCGCCTGTGAGGTAGCT
TTCTATTCGACGACTCCTCTGCAT -> TCTATTCGACGACTCCTCTGCATA
TGCATTGACATAGTCACGCCAAGC -> GCATTGACATAGTCACGCCAAGCG
GGGCCCCAGTGCATTGACATAGTC -> GGCCCCAGTGCATTGACATAGTCA
AACGCTGTTGGACATGTTGGTATC -> ACGCTGTTGGACATGTTGGTATCG
TCAATATTCAGCTCGAATTGTCTG -> CAATATTCAGCTCGAATTGTCTGT
ACTAAAGTATTGAGGTGGCTTCCC -> CTAAAGTATTGAGGTGGCTTCCCC
ATAGGTTATCTGGGAGAATCTTCC -> TAGGTTATCTGGGAGAATCTTCCA
CCCACTGCCAGTGGATCCGCGCGG -> CCACTGCCAGTGGATCCGCGCGGT
AGGAATGCTGGTTAGAGTGCTGGG -> GGAATGCTGGTTAGAGTGCTGGGC
ACGGAGTAGCACGATATGCACCTC -> CGGAGTAGCACGATATGCACCTCG
CTGTTGATTGTAGACGGTTCTGGT -> TGTTGATTGTAGACGGTTCTGGTG
CTAAGAATGACTCGACTCGTTCTG -> TAAGAATGACTCGACTCGTTCTGT
CAATCTTTGCGCCCGAATCTTATC -> AATCTTTGCGCCCGAATCTTATCT
TTATCAGTGCATGAGGGTAAAAGC -> TATCAGTGCATGAGGGTAAAAGCG
TGATACAGGTGCCAACTCGGGTGT -> GATACAGGTGCCAACTCGGGTGTG
TCACACGCCCGGTGTGCTGTATTT -> CACACGCCCGGTGTGCTGTATTTG
ATGAAGTGTGCGTGACTTCAAAAG -> TGAAGTGTGCGTGACTTCAAAAGG
CTTGCGCGACGTATTAAGCTATTG -> TTGCGCGACGTATTAAGCTATTGT
GGGCAACTACCAATAGGTTATCTG -> GGCAACTACCAATAGGTTATCTGG
TGGATGGAAGCATAAGGAAGCCAC -> GGATGGAAGCATAAGGAAGCCACC
ACAGGTGCCAACTCGGGTGTGTTT -> CAGGTGCCAACTCGGGTGTGTTTG
TACGTGGCCGGTCAATTGTGCGGG -> ACGTGGCCGGTCAATTGTGCGGGC
TTGATTGTAGACGGTTCTGGTGGA -> TGATTGTAGACGGTTCTGGTGGAT
CTCTCTATCGTCATTCCGTGAATT -> TCTCTATCGTCATTCCGTGAATTA
AAGATGCAATCATGTCTTACTTAC -> AGATGCAATCATGTCTTACTTACT
TGAAGAGGTCAGTGAAGATGCAAT -> GAAGAGGTCAGTGAAGATGCAATC
TTACTTACTAAGAACGCTGTTGGA -> TACTTACTAAGAACGCTGTTGGAC
CGCCTGTGAGGTAGCTCAACTCGC -> GCCTGTGAGGTAGCTCAACTCGCT
AAAGAGGTAACAAACGAGACGGAG -> AAGAGGTAACAAACGAGACGGAGT
GTAGTTCCTACGCTCATTTTACGT -> TAGTTCCTACGCTCATTTTACGTC
GCATGAGGGTAAAAGCGTCAAGGC -> CATGAGGGTAAAAGCGTCAAGGCT
GCCCGTTATCAGTGCATGAGGGTA -> CCCGTTATCAGTGCATGAGGGTAA
ACCAGGTGCGCATAATCCGGCGCC -> CCAGGTGCGCATAATCCGGCGCCG
GTGCCTGTAGTTCTATTCGACGAC -> TGCCTGTAGTTCTATTCGACGACT
TCAGTGCATGAGGGTAAAAGCGTC -> CAGTGCATGAGGGTAAAAGCGTCA
GGTGCCAACTCGGGTGTGTTTGCG -> GTGCCAACTCGGGTGTGTTTGCGG
TTGCGCGACGTATTAAGCTATTGT -> TGCGCGACGTATTAAGCTATTGTT
TACTAGTCGTGATGCGGTACGGAA -> ACTAGTCGTGATGCGGTACGGAAA
CCAGCCTGACTGCCCGTTGTTTTC -> CAGCCTGACTGCCCGTTGTTTTCG
ATGACCGACGGAGAAGTCTACTAA -> TGACCGACGGAGAAGTCTACTAAA
ATTTGATGCACTGCTCGTTCATGT -> TTTGATGCACTGCTCGTTCATGTC
GTAAAATGCCCTTAACCCATTTCG -> TAAAATGCCCTTAACCCATTTCGC
TTAACAATCTTTGCGCCCGAATCT -> TAACAATCTTTGCGCCCGAATCTT
TTTTCTGTATCACGATGTGCGCGT -> TTTCTGTATCACGATGTGCGCGTT
TAAGCTATTGTTGAAGCCTACCCG -> AAGCTATTGTTGAAGCCTACCCGT
GAATAGTTACGTGGCTGATACAGG -> AATAGTTACGTGGCTGATACAGGT
CAGGAGGCGGGCCGGAGGAGGCAG -> AGGAGGCGGGCCGGAGGAGGCAGA
AAGCTATTGTTGAAGCCTACCCGT -> AGCTATTGTTGAAGCCTACCCGTA
ATAGAGGTATCGAGTGTAATGTAC -> TAGAGGTATCGAGTGTAATGTACT
GAATGCTGGTTAGAGTGCTGGGCT -> AATGCTGGTTAGAGTGCTGGGCTT
TTTGGTATTTACGCCGCATACTAG -> TTGGTATTTACGCCGCATACTAGT
TACTAAGAACGCTGTTGGACATGT -> ACTAAGAACGCTGTTGGACATGTT
TGCTTATTACAGTGGCGCTCTGGG -> GCTTATTACAGTGGCGCTCTGGGC
AAGTATTGAGGTGGCTTCCCCCCT -> AGTATTGAGGTGGCTTCCCCCCTT
ATCTGGGAGAATCTTCCACCAAGA -> TCTGGGAGAATCTTCCACCAAGAA
CATAAGGAAGCCACCAGCCTGACT -> ATAAGGAAGCCACCAGCCTGACTG
AGTCGTGATGCGGTACGGAAATGA -> GTCGTGATGCGGTACGGAAATGAG
TTGGTATCGATGATTTGGTATTTA -> TGGTATCGATGATTTGGTATTTAC
CATAACTCTAACCTGAGGTGCGGG -> ATAACTCTAACCTGAGGTGCGGGC
AAGAAGACATGATATTGTGCCCGG -> AGAAGACATGATATTGTGCCCGGG
AGAACGCTGTTGGACATGTTGGTA -> GAACGCTGTTGGACATGTTGGTAT
CGACTTTCCAGGTAAAATGCCCTT -> GACTTTCCAGGTAAAATGCCCTTA
CCGAAATTGCAGCCTCTTTTTTTC -> CGAAATTGCAGCCTCTTTTTTTCT
TCGTCTTATTTCCAGTGACACTAT -> CGTCTTATTTCCAGTGACACTATC
GCACGATATGCACCTCGTCACAAT -> CACGATATGCACCTCGTCACAATC
CCTGTGAGGTAGCTCAACTCGCTG -> CTGTGAGGTAGCTCAACTCGCTGA
TGGAAGCATAAGGAAGCCACCAGC -> GGAAGCATAAGGAAGCCACCAGCC
GGTATTTACGCCGCATACTAGTCG -> GTATTTACGCCGCATACTAGTCGT
GCGATATCGAGCCCGCCTACCAGG -> CGATATCGAGCCCGCCTACCAGGC
TGATCGTCTTATTTCCAGTGACAC -> GATCGTCTTATTTCCAGTGACACT
CATTTTACGTCGAATAGTTACGTG -> ATTTTACGTCGAATAGTTACGTGG
AGCCACCCATAACTCTAACCTGAG -> GCCACCCATAACTCTAACCTGAGG
TATTTACGCCGCATACTAGTCGTG -> ATTTACGCCGCATACTAGTCGTGA
GATAGAGGTATCGAGTGTAATGTA -> ATAGAGGTATCGAGTGTAATGTAC
TATTACTCATTCTCGGCCGTTGAC -> ATTACTCATTCTCGGCCGTTGACG
TTGTAGACGGTTCTGGTGGATGGA -> TGTAGACGGTTCTGGTGGATGGAA
CCACCCATAACTCTAACCTGAGGT -> CACCCATAACTCTAACCTGAGGTG
CGTTGTTCAATATTCAGCTCGAAT -> GTTGTTCAATATTCAGCTCGAATT
GGTGCCTGTAGTTCTATTCGACGA -> GTGCCTGTAGTTCTATTCGACGAC
ATAATCCGGCGCCGTCGGTCACAC -> TAATCCGGCGCCGTCGGTCACACG
TGTAGTTCTATTCGACGACTCCTC -> GTAGTTCTATTCGACGACTCCTCT
AGAAGGCATGATAATCTGGGCGAC -> GAAGGCATGATAATCTGGGCGACT
AAGGCAGATTCCAGCACCTCAATG -> AGGCAGATTCCAGCACCTCAATGA
TTTGAGGTGCCTGTAGTTCTATTC -> TTGAGGTGCCTGTAGTTCTATTCG
GCGTTGTTCAATATTCAGCTCGAA -> CGTTGTTCAATATTCAGCTCGAAT
GGTGTGCTGTATTTGATGCACTGC -> GTGTGCTGTATTTGATGCACTGCT
CGGTATCATAATGCTGTGCGCCAA -> GGTATCATAATGCTGTGCGCCAAA
CATTCCGTGAATTATCCGTAGTTC -> ATTCCGTGAATTATCCGTAGTTCC
TTCGTATGCCTCTTGCGCGACGTA -> TCGTATGCCTCTTGCGCGACGTAT
GAAGACATGATATTGTGCCCGGGG -> AAGACATGATATTGTGCCCGGGGA
CATATATCATCGGGCTGCCATCGA -> ATATATCATCGGGCTGCCATCGAA
AGCGTGCTTATCCACGGACGTGAC -> GCGTGCTTATCCACGGACGTGACA
GCCATCGAAGCAGGAGGCGGGCCG -> CCATCGAAGCAGGAGGCGGGCCGG
TCGAGAGCATCCTCTAGGTAAACG -> CGAGAGCATCCTCTAGGTAAACGG
CCCGCCTACCAGGCCTGTTGATTG -> CCGCCTACCAGGCCTGTTGATTGT
TGCAATCATGTCTTACTTACTAAG -> GCAATCATGTCTTACTTACTAAGA
GTTCTATTCGACGACTCCTCTGCA -> TTCTATTCGACGACTCCTCTGCAT
ATGCCCCGATGTAGCCCTTCTTTT -> TGCCCCGATGTAGCCCTTCTTTTG
GAGGTGCCTGTAGTTCTATTCGAC -> AGGTGCCTGTAGTTCTATTCGACG
GCCGGAGGAGGCAGAGACCAGGAT -> CCGGAGGAGGCAGAGACCAGGATT
GGACGTGACAACTTGAAGAGGTCA -> GACGTGACAACTTGAAGAGGTCAG
TCCTTCTAGGGCCCCAGTGCATTG -> CCTTCTAGGGCCCCAGTGCATTGA
CTACTAAAGTATTGAGGTGGCTTC -> TACTAAAGTATTGAGGTGGCTTCC
TCATAATGCTGTGCGCCAAAAGAT -> CATAATGCTGTGCGCCAAAAGATG
AGCCAGCCACCCATAACTCTAACC -> GCCAGCCACCCATAACTCTAACCT
GCCGCGGAGAGTAGAGTTAAGTTG -> CCGCGGAGAGTAGAGTTAAGTTGG
GCCCGAATCTTATCTATGATCGTC -> CCCGAATCTTATCTATGATCGTCT
CGTCATTCCGTGAATTATCCGTAG -> GTCATTCCGTGAATTATCCGTAGT
GCCTAAACCAGGTGCGCATAATCC -> CCTAAACCAGGTGCGCATAATCCG
ACTTGAAGAGGTCAGTGAAGATGC -> CTTGAAGAGGTCAGTGAAGATGCA
GACGCCCGTTATCAGTGCATGAGG -> ACGCCCGTTATCAGTGCATGAGGG
GCTTCCCCCCTTCTTACCCATTTG -> CTTCCCCCCTTCTTACCCATTTGA
TGAGATAAAGAGGTAACAAACGAG -> GAGATAAAGAGGTAACAAACGAGA
GCATGATAATCTGGGCGACTAAGA -> CATGATAATCTGGGCGACTAAGAA
CCAAGCGGGTGTTCTATCTTGCCG -> CAAGCGGGTGTTCTATCTTGCCGA
GCGTGCTTATCCACGGACGTGACA -> CGTGCTTATCCACGGACGTGACAA
ACGTTAGGTATTCGCGTTGCCGAT -> CGTTAGGTATTCGCGTTGCCGATT
AAGTTGATCGGTATCATAATGCTG -> AGTTGATCGGTATCATAATGCTGT
GCGACTAAGAATGACTCGACTCGT -> CGACTAAGAATGACTCGACTCGTT
GGGTAAAAGCGTCAAGGCTCGGTT -> GGTAAAAGCGTCAAGGCTCGGTTC
GGCCCCAGTGCATTGACATAGTCA -> GCCCCAGTGCATTGACATAGTCAC
GGCGACTAAGAATGACTCGACTCG -> GCGACTAAGAATGACTCGACTCGT
TCTGGGCGACTAAGAATGACTCGA -> CTGGGCGACTAAGAATGACTCGAC
CGTTCTGTCTATTACAAGCGTGCT -> GTTCTGTCTATTACAAGCGTGCTT
GGTAAAAGCGTCAAGGCTCGGTTC -> GTAAAAGCGTCAAGGCTCGGTTCG
TTACAGTGGCGCTCTGGGCGTCGA -> TACAGTGGCGCTCTGGGCGTCGAG
CGTTGTTTTCGGCTGTCCTTCTAG -> GTTGTTTTCGGCTGTCCTTCTAGG
ATGATTTGGTATTTACGCCGCATA -> TGATTTGGTATTTACGCCGCATAC
ATATGTTGCATACGAACCCGCCAG -> TATGTTGCATACGAACCCGCCAGG
CCCATCTCTGGGGCAATGCCTAAA -> CCATCTCTGGGGCAATGCCTAAAC
GTGTTTGCGGGGCTAAGGCTCGTT -> TGTTTGCGGGGCTAAGGCTCGTTA
CCCCCCTTCTTACCCATTTGAGGT -> CCCCCTTCTTACCCATTTGAGGTG
CTCCCGGGGGGAAGCCAGCCACCC -> TCCCGGGGGGAAGCCAGCCACCCA
TAATGCTGTGCGCCAAAAGATGAC -> AATGCTGTGCGCCAAAAGATGACC
TTTTCGGCTGTCCTTCTAGGGCCC -> TTTCGGCTGTCCTTCTAGGGCCCC
GCCAACTCGGGTGTGTTTGCGGGG -> CCAACTCGGGTGTGTTTGCGGGGC
TTTTGTTCCCGCTCTGCTTATTAC -> TTTGTTCCCGCTCTGCTTATTACA
TACCCATCTCTGGGGCAATGCCTA -> ACCCATCTCTGGGGCAATGCCTAA
GAAGCAGGAGGCGGGCCGGAGGAG -> AAGCAGGAGGCGGGCCGGAGGAGG
CACCGGACTGATATTGCAGGGAAG -> ACCGGACTGATATTGCAGGGAAGA
TCAATTGTGCGGGCGAGCACCGGA -> CAATTGTGCGGGCGAGCACCGGAC
AGGCGGGCCGGAGGAGGCAGAGAC -> GGCGGGCCGGAGGAGGCAGAGACC
CATGTCTAATTGCCCCAAAAGATA -> ATGTCTAATTGCCCCAAAAGATAG
TACGAACCCGCCAGGAATGCTGGT -> ACGAACCCGCCAGGAATGCTGGTT
CGAACTCTCTATCGTCATTCCGTG -> GAACTCTCTATCGTCATTCCGTGA
TCTGTATCACGATGTGCGCGTTGT -> CTGTATCACGATGTGCGCGTTGTT
CTACCAGGCCTGTTGATTGTAGAC -> TACCAGGCCTGTTGATTGTAGACG
CAGGCCTGTTGATTGTAGACGGTT -> AGGCCTGTTGATTGTAGACGGTTC
AATTGTCTGTGCCCACTGCCAGTG -> ATTGTCTGTGCCCACTGCCAGTGG
CGGGTGTGTTTGCGGGGCTAAGGC -> GGGTGTGTTTGCGGGGCTAAGGCT
GCAGGAGGCGGGCCGGAGGAGGCA -> CAGGAGGCGGGCCGGAGGAGGCAG
ACTGCCCGTTGTTTTCGGCTGTCC -> CTGCCCGTTGTTTTCGGCTGTCCT
TTCGCCTGTGAGGTAGCTCAACTC -> TCGCCTGTGAGGTAGCTCAACTCG
AATGAAGTGTGCGTGACTTCAAAA -> ATGAAGTGTGCGTGACTTCAAAAG
GGTATCGAGTGTAATGTACTAAGT -> GTATCGAGTGTAATGTACTAAGTC
CCCGGGGAACTGAGATAAAGAGGT -> CCGGGGAACTGAGATAAAGAGGTA
TTAAGCTATTGTTGAAGCCTACCC -> TAAGCTATTGTTGAAGCCTACCCG
TGCATACGAACCCGCCAGGAATGC -> GCATACGAACCCGCCAGGAATGCT
ACAGTGGCGCTCTGGGCGTCGAGA -> CAGTGGCGCTCTGGGCGTCGAGAG
CTCAACTCGCTGAAAACATATTAC -> TCAACTCGCTGAAAACATATTACT
CTTGCCTTTAGTGATTCATTAAAG -> TTGCCTTTAGTGATTCATTAAAGA
GATGCAATCATGTCTTACTTACTA -> ATGCAATCATGTCTTACTTACTAA
TGACAACTTGAAGAGGTCAGTGAA -> GACAACTTGAAGAGGTCAGTGAAG
TCTTACCCATTTGAGGTGCCTGTA -> CTTACCCATTTGAGGTGCCTGTAG
TGCCCCAAAAGATAGAGGTATCGA -> GCCCCAAAAGATAGAGGTATCGAG
CGGGCAACTACCAATAGGTTATCT -> GGGCAACTACCAATAGGTTATCTG
GGGAACTGAGATAAAGAGGTAACA -> GGAACTGAGATAAAGAGGTAACAA
CTGGGAGAATCTTCCACCAAGAAT -> TGGGAGAATCTTCCACCAAGAATG
ATCACGATGTGCGCGTTGTTCAAT -> TCACGATGTGCGCGTTGTTCAATA
CCTCTTTTTTTCTGTATCACGATG -> CTCTTTTTTTCTGTATCACGATGT
CGCTCTGCTTATTACAGTGGCGCT -> GCTCTGCTTATTACAGTGGCGCTC
TGCCTCTTGCGCGACGTATTAAGC -> GCCTCTTGCGCGACGTATTAAGCT
CCGATTCAAGGCAGATTCCAGCAC -> CGATTCAAGGCAGATTCCAGCACC
GTGATTCATTAAAGAAGACATGAT -> TGATTCATTAAAGAAGACATGATA
CCGGAGGAGGCAGAGACCAGGATT -> CGGAGGAGGCAGAGACCAGGATTG
GTTCTGGTGGATGGAAGCATAAGG -> TTCTGGTGGATGGAAGCATAAGGA
AACAAACGAGACGGAGTAGCACGA -> ACAAACGAGACGGAGTAGCACGAT
GTGGATGGAAGCATAAGGAAGCCA -> TGGATGGAAGCATAAGGAAGCCAC
CGGACGTGACAACTTGAAGAGGTC -> GGACGTGACAACTTGAAGAGGTCA
TTCCACCAAGAATGCCCCGATGTA -> TCCACCAAGAATGCCCCGATGTAG
TGATGCACTGCTCGTTCATGTCTA -> GATGCACTGCTCGTTCATGTCTAA
GACTCGTTCTGTCTATTACAAGCG -> ACTCGTTCTGTCTATTACAAGCGT
GCGGTACGGAAATGAGACGCGATA -> CGGTACGGAAATGAGACGCGATAT
CTAAAGTATTGAGGTGGCTTCCCC -> TAAAGTATTGAGGTGGCTTCCCCC
CTAAGTCCAGCTACGTGGCCGGTC -> TAAGTCCAGCTACGTGGCCGGTCA
TTCTGTATCACGATGTGCGCGTTG -> TCTGTATCACGATGTGCGCGTTGT
CAATAGGTTATCTGGGAGAATCTT -> AATAGGTTATCTGGGAGAATCTTC
CTGGGGATTGATAAGCCGCGGAGA -> TGGGGATTGATAAGCCGCGGAGAG
CCTTCTAGGGCCCCAGTGCATTGA -> CTTCTAGGGCCCCAGTGCATTGAC
GTAACAAACGAGACGGAGTAGCAC -> TAACAAACGAGACGGAGTAGCACG
GACTTCAAAAGGACTCCCGGGGGG -> ACTTCAAAAGGACTCCCGGGGGGA
TCTATTACAAGCGTGCTTATCCAC -> CTATTACAAGCGTGCTTATCCACG
GTTCATGTCTAATTGCCCCAAAAG -> TTCATGTCTAATTGCCCCAAAAGA
TAAAGAAGACATGATATTGTGCCC -> AAAGAAGACATGATATTGTGCCCG
CCTTTAGTGATTCATTAAAGAAGA -> CTTTAGTGATTCATTAAAGAAGAC
TCGTATGCCTCTTGCGCGACGTAT -> CGTATGCCTCTTGCGCGACGTATT
CTTCCCCCCTTCTTACCCATTTGA -> TTCCCCCCTTCTTACCCATTTGAG
AGTGATTCATTAAAGAAGACATGA -> GTGATTCATTAAAGAAGACATGAT
GATCGTCTTATTTCCAGTGACACT -> ATCGTCTTATTTCCAGTGACACTA
CTGTGAGGTAGCTCAACTCGCTGA -> TGTGAGGTAGCTCAACTCGCTGAA
TTCCAGTGACACTATCCCGAAATT -> TCCAGTGACACTATCCCGAAATTG
GTGAAGATGCAATCATGTCTTACT -> TGAAGATGCAATCATGTCTTACTT
CGCCGTCGGTCACACGCCCGGTGT -> GCCGTCGGTCACACGCCCGGTGTG
GTGGCTTCCCCCCTTCTTACCCAT -> TGGCTTCCCCCCTTCTTACCCATT
CATGTCTTACTTACTAAGAACGCT -> ATGTCTTACTTACTAAGAACGCTG
GGGGAAGCCAGCCACCCATAACTC -> GGGAAGCCAGCCACCCATAACTCT
GTGCGTGACTTCAAAAGGACTCCC -> TGCGTGACTTCAAAAGGACTCCCG
GCTGAAAACATATTACTCATTCTC -> CTGAAAACATATTACTCATTCTCG
TCGAATTGTCTGTGCCCACTGCCA -> CGAATTGTCTGTGCCCACTGCCAG
GACTGCCCGTTGTTTTCGGCTGTC -> ACTGCCCGTTGTTTTCGGCTGTCC
TAGTCGTGATGCGGTACGGAAATG -> AGTCGTGATGCGGTACGGAAATGA
CGGGCTGCCATCGAAGCAGGAGGC -> GGGCTGCCATCGAAGCAGGAGGCG
GACAACTTGAAGAGGTCAGTGAAG -> ACAACTTGAAGAGGTCAGTGAAGA
CGGCCGTTGACGCCCGTTATCAGT -> GGCCGTTGACGCCCGTTATCAGTG
CCCTTAACCCATTTCGCCTGTGAG -> CCTTAACCCATTTCGCCTGTGAGG
GTAGCCCTTCTTTTGTTCCCGCTC -> TAGCCCTTCTTTTGTTCCCGCTCT
ACCCGTAAGCCTGGGGATTGATAA -> CCCGTAAGCCTGGGGATTGATAAG
ATACCCATCTCTGGGGCAATGCCT -> TACCCATCTCTGGGGCAATGCCTA
GTTCAATATTCAGCTCGAATTGTC -> TTCAATATTCAGCTCGAATTGTCT
GCCGATTCAAGGCAGATTCCAGCA -> CCGATTCAAGGCAGATTCCAGCAC
TACCAATAGGTTATCTGGGAGAAT -> ACCAATAGGTTATCTGGGAGAATC
AAGAGGTAACAAACGAGACGGAGT -> AGAGGTAACAAACGAGACGGAGTA
TAAACGGTGTCGGATACCCATCTC -> AAACGGTGTCGGATACCCATCTCT
GCCTTTAGTGATTCATTAAAGAAG -> CCTTTAGTGATTCATTAAAGAAGA
GGTAAAATGCCCTTAACCCATTTC -> GTAAAATGCCCTTAACCCATTTCG
AGGCATGATAATCTGGGCGACTAA -> GGCATGATAATCTGGGCGACTAAG
CCATCGAAGCAGGAGGCGGGCCGG -> CATCGAAGCAGGAGGCGGGCCGGA
GTGCGCCAAAAGATGACCGACGGA -> TGCGCCAAAAGATGACCGACGGAG
AGTTCCTACGCTCATTTTACGTCG -> GTTCCTACGCTCATTTTACGTCGA
GATCCGCGCGGTACCGTGTTGGGG -> ATCCGCGCGGTACCGTGTTGGGGA
TGCATGAGGGTAAAAGCGTCAAGG -> GCATGAGGGTAAAAGCGTCAAGGC
CCAGGAATGCTGGTTAGAGTGCTG -> CAGGAATGCTGGTTAGAGTGCTGG
TCTGGTGGATGGAAGCATAAGGAA -> CTGGTGGATGGAAGCATAAGGAAG
AATGACTCGACTCGTTCTGTCTAT -> ATGACTCGACTCGTTCTGTCTATT
TTAAGTTGGCATGAAGTTGATCGG -> TAAGTTGGCATGAAGTTGATCGGT
AGATAGAGGTATCGAGTGTAATGT -> GATAGAGGTATCGAGTGTAATGTA
CCCATTTCGCCTGTGAGGTAGCTC -> CCATTTCGCCTGTGAGGTAGCTCA
CTCTGCATATATCATCGGGCTGCC -> TCTGCATATATCATCGGGCTGCCA
ACGAGACGGAGTAGCACGATATGC -> CGAGACGGAGTAGCACGATATGCA
GTCACAATCGAACTCTCTATCGTC -> TCACAATCGAACTCTCTATCGTCA
CACGGACGTGACAACTTGAAGAGG -> ACGGACGTGACAACTTGAAGAGGT
TATCATAATGCTGTGCGCCAAAAG -> ATCATAATGCTGTGCGCCAAAAGA
CTCTTGCGCGACGTATTAAGCTAT -> TCTTGCGCGACGTATTAAGCTATT
GCATATATCATCGGGCTGCCATCG -> CATATATCATCGGGCTGCCATCGA
TTCGCGTTGCCGATTCAAGGCAGA -> TCGCGTTGCCGATTCAAGGCAGAT
GCTGCCATCGAAGCAGGAGGCGGG -> CTGCCATCGAAGCAGGAGGCGGGC
GTAAACGGTGTCGGATACCCATCT -> TAAACGGTGTCGGATACCCATCTC
AAAGGACTCCCGGGGGGAAGCCAG -> AAGGACTCCCGGGGGGAAGCCAGC
AATGTACTAAGTCCAGCTACGTGG -> ATGTACTAAGTCCAGCTACGTGGC
GTCAAGGCTCGGTTCGTATGCCTC -> TCAAGGCTCGGTTCGTATGCCTCT
TAAGTTGGCATGAAGTTGATCGGT -> AAGTTGGCATGAAGTTGATCGGTA
CATTCTCGGCCGTTGACGCCCGTT -> ATTCTCGGCCGTTGACGCCCGTTA
TTGCCTTTAGTGATTCATTAAAGA -> TGCCTTTAGTGATTCATTAAAGAA
CTGGTTAGAGTGCTGGGCTTGCCT -> TGGTTAGAGTGCTGGGCTTGCCTT
TGTTGCATACGAACCCGCCAGGAA -> GTTGCATACGAACCCGCCAGGAAT
TTCCCCCCTTCTTACCCATTTGAG -> TCCCCCCTTCTTACCCATTTGAGG
TTGCCGATATGTTGCATACGAACC -> TGCCGATATGTTGCATACGAACCC
GCAGCCTCTTTTTTTCTGTATCAC -> CAGCCTCTTTTTTTCTGTATCACG
CGCCCGGTGTGCTGTATTTGATGC -> GCCCGGTGTGCTGTATTTGATGCA
TTATCTATGATCGTCTTATTTCCA -> TATCTATGATCGTCTTATTTCCAG
TCTCGGCCGTTGACGCCCGTTATC -> CTCGGCCGTTGACGCCCGTTATCA
ATAGTTACGTGGCTGATACAGGTG -> TAGTTACGTGGCTGATACAGGTGC
CGAACCCGCCAGGAATGCTGGTTA -> GAACCCGCCAGGAATGCTGGTTAG
CATTGACATAGTCACGCCAAGCGG -> ATTGACATAGTCACGCCAAGCGGG
CTTCTTACCCATTTGAGGTGCCTG -> TTCTTACCCATTTGAGGTGCCTGT
AGGTATCGAGTGTAATGTACTAAG -> GGTATCGAGTGTAATGTACTAAGT
AAATGAGACGCGATATCGAGCCCG -> AATGAGACGCGATATCGAGCCCGC
GATATGTTGCATACGAACCCGCCA -> ATATGTTGCATACGAACCCGCCAG
TCTACTAAAGTATTGAGGTGGCTT -> CTACTAAAGTATTGAGGTGGCTTC
GGTTATCTGGGAGAATCTTCCACC -> GTTATCTGGGAGAATCTTCCACCA
AATGCTGGTTAGAGTGCTGGGCTT -> ATGCTGGTTAGAGTGCTGGGCTTG
ATACAGGTGCCAACTCGGGTGTGT -> TACAGGTGCCAACTCGGGTGTGTT
TAATTGCCCCAAAAGATAGAGGTA -> AATTGCCCCAAAAGATAGAGGTAT
GAATGACTCGACTCGTTCTGTCTA -> AATGACTCGACTCGTTCTGTCTAT
GGAAGCCACCAGCCTGACTGCCCG -> GAAGCCACCAGCCTGACTGCCCGT
CGTGACAACTTGAAGAGGTCAGTG -> GTGACAACTTGAAGAGGTCAGTGA
GGGGATTGATAAGCCGCGGAGAGT -> GGGATTGATAAGCCGCGGAGAGTA
ACTTCAAAAGGACTCCCGGGGGGA -> CTTCAAAAGGACTCCCGGGGGGAA
TTAGTGATTCATTAAAGAAGACAT -> TAGTGATTCATTAAAGAAGACATG
AGGTAAACGGTGTCGGATACCCAT -> GGTAAACGGTGTCGGATACCCATC
GTGCGGGCGAGCACCGGACTGATA -> TGCGGGCGAGCACCGGACTGATAT
CCATTTCGCCTGTGAGGTAGCTCA -> CATTTCGCCTGTGAGGTAGCTCAA
ACGATGTGCGCGTTGTTCAATATT -> CGATGTGCGCGTTGTTCAATATTC
AAGAACGCTGTTGGACATGTTGGT -> AGAACGCTGTTGGACATGTTGGTA
TGTTGGTATCGATGATTTGGTATT -> GTTGGTATCGATGATTTGGTATTT
GACCGACGGAGAAGTCTACTAAAG -> ACCGACGGAGAAGTCTACTAAAGT
TAACCCATTTCGCCTGTGAGGTAG -> AACCCATTTCGCCTGTGAGGTAGC
CATCGAAGCAGGAGGCGGGCCGGA -> ATCGAAGCAGGAGGCGGGCCGGAG
GTCTGTGCCCACTGCCAGTGGATC -> TCTGTGCCCACTGCCAGTGGATCC
TCCAGCTACGTGGCCGGTCAATTG -> CCAGCTACGTGGCCGGTCAATTGT
CCGCCTACCAGGCCTGTTGATTGT -> CGCCTACCAGGCCTGTTGATTGTA
AAAAGCGTCAAGGCTCGGTTCGTA -> AAAGCGTCAAGGCTCGGTTCGTAT
TTTACGTCGAATAGTTACGTGGCT -> TTACGTCGAATAGTTACGTGGCTG
GAGACGCGATATCGAGCCCGCCTA -> AGACGCGATATCGAGCCCGCCTAC
AATGAGACGCGATATCGAGCCCGC -> ATGAGACGCGATATCGAGCCCGCC
CGTCACAATCGAACTCTCTATCGT -> GTCACAATCGAACTCTCTATCGTC
TGTTGAAGCCTACCCGTAAGCCTG -> GTTGAAGCCTACCCGTAAGCCTGG
ACCTCAATGAAGTGTGCGTGACTT -> CCTCAATGAAGTGTGCGTGACTTC
GAGGTGGCTTCCCCCCTTCTTACC -> AGGTGGCTTCCCCCCTTCTTACCC
CGCCTACCAGGCCTGTTGATTGTA -> GCCTACCAGGCCTGTTGATTGTAG
CGCTGAAAACATATTACTCATTCT -> GCTGAAAACATATTACTCATTCTC
AGAGTAGAGTTAAGTTGGCATGAA -> GAGTAGAGTTAAGTTGGCATGAAG
ACGTGGCCGGTCAATTGTGCGGGC -> CGTGGCCGGTCAATTGTGCGGGCG
GGATCCGCGCGGTACCGTGTTGGG -> GATCCGCGCGGTACCGTGTTGGGG
TCGCGTTGCCGATTCAAGGCAGAT -> CGCGTTGCCGATTCAAGGCAGATT
CAACTACCAATAGGTTATCTGGGA -> AACTACCAATAGGTTATCTGGGAG
ATTGCCCCAAAAGATAGAGGTATC -> TTGCCCCAAAAGATAGAGGTATCG
CAGGAATGCTGGTTAGAGTGCTGG -> AGGAATGCTGGTTAGAGTGCTGGG
CGACTCGTTCTGTCTATTACAAGC -> GACTCGTTCTGTCTATTACAAGCG
AGGCAGATTCCAGCACCTCAATGA -> GGCAGATTCCAGCACCTCAATGAA
GTGCTGTATTTGATGCACTGCTCG -> TGCTGTATTTGATGCACTGCTCGT
CGGTCACACGCCCGGTGTGCTGTA -> GGTCACACGCCCGGTGTGCTGTAT
GAAGCCACCAGCCTGACTGCCCGT -> AAGCCACCAGCCTGACTGCCCGTT
TGAAGTTGATCGGTATCATAATGC -> GAAGTTGATCGGTATCATAATGCT
AAGCCGCGGAGAGTAGAGTTAAGT -> AGCCGCGGAGAGTAGAGTTAAGTT
TCTGGGGCAATGCCTAAACCAGGT -> CTGGGGCAATGCCTAAACCAGGTG
TTGTGCGGGCGAGCACCGGACTGA -> TGTGCGGGCGAGCACCGGACTGAT
GGAGTAGCACGATATGCACCTCGT -> GAGTAGCACGATATGCACCTCGTC
GGCTCGGTTCGTATGCCTCTTGCG -> GCTCGGTTCGTATGCCTCTTGCGC
GTGCATTGACATAGTCACGCCAAG -> TGCATTGACATAGTCACGCCAAGC
GTGCATGAGGGTAAAAGCGTCAAG -> TGCATGAGGGTAAAAGCGTCAAGG
TTCAATATTCAGCTCGAATTGTCT -> TCAATATTCAGCTCGAATTGTCTG
CAGTGGCGCTCTGGGCGTCGAGAG -> AGTGGCGCTCTGGGCGTCGAGAGC
CCCATAACTCTAACCTGAGGTGCG -> CCATAACTCTAACCTGAGGTGCGG
GGGATTGATAAGCCGCGGAGAGTA -> GGATTGATAAGCCGCGGAGAGTAG
AGCCTACCCGTAAGCCTGGGGATT -> GCCTACCCGTAAGCCTGGGGATTG
TTGCCGATTCAAGGCAGATTCCAG -> TGCCGATTCAAGGCAGATTCCAGC
GTCGAGAGCATCCTCTAGGTAAAC -> TCGAGAGCATCCTCTAGGTAAACG
GGGCTAAGGCTCGTTAACAATCTT -> GGCTAAGGCTCGTTAACAATCTTT
CGCCAAGCGGGTGTTCTATCTTGC -> GCCAAGCGGGTGTTCTATCTTGCC
TGCGCGTTGTTCAATATTCAGCTC -> GCGCGTTGTTCAATATTCAGCTCG
GAGCACCGGACTGATATTGCAGGG -> AGCACCGGACTGATATTGCAGGGA
GATGGAAGCATAAGGAAGCCACCA -> ATGGAAGCATAAGGAAGCCACCAG
CCGCTCTGCTTATTACAGTGGCGC -> CGCTCTGCTTATTACAGTGGCGCT
CCTCTAGGTAAACGGTGTCGGATA -> CTCTAGGTAAACGGTGTCGGATAC
CTATTGTTGAAGCCTACCCGTAAG -> TATTGTTGAAGCCTACCCGTAAGC
CCTCTGCATATATCATCGGGCTGC -> CTCTGCATATATCATCGGGCTGCC
ATAAAGAGGTAACAAACGAGACGG -> TAAAGAGGTAACAAACGAGACGGA
TTTGTTCCCGCTCTGCTTATTACA -> TTGTTCCCGCTCTGCTTATTACAG
TCTTTGCGCCCGAATCTTATCTAT -> CTTTGCGCCCGAATCTTATCTATG
TCTGTGCCCACTGCCAGTGGATCC -> CTGTGCCCACTGCCAGTGGATCCG
GAGTAGCACGATATGCACCTCGTC -> AGTAGCACGATATGCACCTCGTCA
TTATCCGTAGTTCCTACGCTCATT -> TATCCGTAGTTCCTACGCTCATTT
CATCGGGCTGCCATCGAAGCAGGA -> ATCGGGCTGCCATCGAAGCAGGAG
GCCCCAGTGCATTGACATAGTCAC -> CCCCAGTGCATTGACATAGTCACG
CTATTCGACGACTCCTCTGCATAT -> TATTCGACGACTCCTCTGCATATA
AAACATATTACTCATTCTCGGCCG -> AACATATTACTCATTCTCGGCCGT
ACTGCTCGTTCATGTCTAATTGCC -> CTGCTCGTTCATGTCTAATTGCCC
GTTCGTATGCCTCTTGCGCGACGT -> TTCGTATGCCTCTTGCGCGACGTA
CCCAGTGCATTGACATAGTCACGC -> CCAGTGCATTGACATAGTCACGCC
TAAAAGCGTCAAGGCTCGGTTCGT -> AAAAGCGTCAAGGCTCGGTTCGTA
TGTATTTGATGCACTGCTCGTTCA -> GTATTTGATGCACTGCTCGTTCAT
GGCAGATTCCAGCACCTCAATGAA -> GCAGATTCCAGCACCTCAATGAAG
GCCGACTTTCCAGGTAAAATGCCC -> CCGACTTTCCAGGTAAAATGCCCT
GCTTATTACAGTGGCGCTCTGGGC -> CTTATTACAGTGGCGCTCTGGGCG
TCGCCTGTGAGGTAGCTCAACTCG -> CGCCTGTGAGGTAGCTCAACTCGC
AGGTGCGCATAATCCGGCGCCGTC -> GGTGCGCATAATCCGGCGCCGTCG
TAGTTCCTACGCTCATTTTACGTC -> AGTTCCTACGCTCATTTTACGTCG
AAGGCATGATAATCTGGGCGACTA -> AGGCATGATAATCTGGGCGACTAA
GTGTGCGTGACTTCAAAAGGACTC -> TGTGCGTGACTTCAAAAGGACTCC
ACGCCAAGCGGGTGTTCTATCTTG -> CGCCAAGCGGGTGTTCTATCTTGC
TTATTACAGTGGCGCTCTGGGCGT -> TATTACAGTGGCGCTCTGGGCGTC
TCTTATTTCCAGTGACACTATCCC -> CTTATTTCCAGTGACACTATCCCG
CGAGTGTAATGTACTAAGTCCAGC -> GAGTGTAATGTACTAAGTCCAGCT
TCGATGATTTGGTATTTACGCCGC -> CGATGATTTGGTATTTACGCCGCA
ACCAAGAATGCCCCGATGTAGCCC -> CCAAGAATGCCCCGATGTAGCCCT
CCGCCAGGAATGCTGGTTAGAGTG -> CGCCAGGAATGCTGGTTAGAGTGC
CCCCAAAAGATAGAGGTATCGAGT -> CCCAAAAGATAGAGGTATCGAGTG
TCCGTAGTTCCTACGCTCATTTTA -> CCGTAGTTCCTACGCTCATTTTAC
TGGCTGATACAGGTGCCAACTCGG -> GGCTGATACAGGTGCCAACTCGGG
AGTCACGCCAAGCGGGTGTTCTAT -> GTCACGCCAAGCGGGTGTTCTATC
CAAAAGGACTCCCGGGGGGAAGCC -> AAAAGGACTCCCGGGGGGAAGCCA
ACGAACCCGCCAGGAATGCTGGTT -> CGAACCCGCCAGGAATGCTGGTTA
GTAGAGTTAAGTTGGCATGAAGTT -> TAGAGTTAAGTTGGCATGAAGTTG
AGCTATTGTTGAAGCCTACCCGTA -> GCTATTGTTGAAGCCTACCCGTAA
AATATTCAGCTCGAATTGTCTGTG -> ATATTCAGCTCGAATTGTCTGTGC
ACGGAGAAGTCTACTAAAGTATTG -> CGGAGAAGTCTACTAAAGTATTGA
CGACGTATTAAGCTATTGTTGAAG -> GACGTATTAAGCTATTGTTGAAGC
CCCCCTTCTTACCCATTTGAGGTG -> CCCCTTCTTACCCATTTGAGGTGC
AGTGACACTATCCCGAAATTGCAG -> GTGACACTATCCCGAAATTGCAGC
GTCTTACTTACTAAGAACGCTGTT -> TCTTACTTACTAAGAACGCTGTTG
CGGCTGTCCTTCTAGGGCCCCAGT -> GGCTGTCCTTCTAGGGCCCCAGTG
GGTAGCTCAACTCGCTGAAAACAT -> GTAGCTCAACTCGCTGAAAACATA
CCGCGCGGTACCGTGTTGGGGATG -> CGCGCGGTACCGTGTTGGGGATGA
TTGATAAGCCGCGGAGAGTAGAGT -> TGATAAGCCGCGGAGAGTAGAGTT
TCCCGAAATTGCAGCCTCTTTTTT -> CCCGAAATTGCAGCCTCTTTTTTT
GAGTGCTGGGCTTGCCTTTAGTGA -> AGTGCTGGGCTTGCCTTTAGTGAT
TTGGACATGTTGGTATCGATGATT -> TGGACATGTTGGTATCGATGATTT
TGTGCCCGGGGAACTGAGATAAAG -> GTGCCCGGGGAACTGAGATAAAGA
TCGAGTGTAATGTACTAAGTCCAG -> CGAGTGTAATGTACTAAGTCCAGC
TACCCGTAAGCCTGGGGATTGATA -> ACCCGTAAGCCTGGGGATTGATAA
GGAGGCGGGCCGGAGGAGGCAGAG -> GAGGCGGGCCGGAGGAGGCAGAGA
GTGGATCCGCGCGGTACCGTGTTG -> TGGATCCGCGCGGTACCGTGTTGG
TAAGCCTGGGGATTGATAAGCCGC -> AAGCCTGGGGATTGATAAGCCGCG
ATTCCGTGAATTATCCGTAGTTCC -> TTCCGTGAATTATCCGTAGTTCCT
CATACGAACCCGCCAGGAATGCTG -> ATACGAACCCGCCAGGAATGCTGG
GCAGGGAAGAAGGCATGATAATCT -> CAGGGAAGAAGGCATGATAATCTG
AGCGGGTGTTCTATCTTGCCGACT -> GCGGGTGTTCTATCTTGCCGACTT
AAGGAAGCCACCAGCCTGACTGCC -> AGGAAGCCACCAGCCTGACTGCCC
CCAACTCGGGTGTGTTTGCGGGGC -> CAACTCGGGTGTGTTTGCGGGGCT
TCATTAAAGAAGACATGATATTGT -> CATTAAAGAAGACATGATATTGTG
AAGTCTACTAAAGTATTGAGGTGG -> AGTCTACTAAAGTATTGAGGTGGC
CGCCAGGAATGCTGGTTAGAGTGC -> GCCAGGAATGCTGGTTAGAGTGCT
GGAGGAGGCAGAGACCAGGATTGC -> GAGGAGGCAGAGACCAGGATTGCC
GTTAGGTATTCGCGTTGCCGATTC -> TTAGGTATTCGCGTTGCCGATTCA
TAGTGATTCATTAAAGAAGACATG -> AGTGATTCATTAAAGAAGACATGA
ACCGACGGAGAAGTCTACTAAAGT -> CCGACGGAGAAGTCTACTAAAGTA
GAGACCAGGATTGCCGATATGTTG -> AGACCAGGATTGCCGATATGTTGC
TCGGATACCCATCTCTGGGGCAAT -> CGGATACCCATCTCTGGGGCAATG
AGAGGTCAGTGAAGATGCAATCAT -> GAGGTCAGTGAAGATGCAATCATG
GAATCTTATCTATGATCGTCTTAT -> AATCTTATCTATGATCGTCTTATT
GTCGTGATGCGGTACGGAAATGAG -> TCGTGATGCGGTACGGAAATGAGA
AAAGATAGAGGTATCGAGTGTAAT -> AAGATAGAGGTATCGAGTGTAATG
CGGAGTAGCACGATATGCACCTCG -> GGAGTAGCACGATATGCACCTCGT
TAGAGTGCTGGGCTTGCCTTTAGT -> AGAGTGCTGGGCTTGCCTTTAGTG
TACAGTGGCGCTCTGGGCGTCGAG -> ACAGTGGCGCTCTGGGCGTCGAGA
CTGGGCGACTAAGAATGACTCGAC -> TGGGCGACTAAGAATGACTCGACT
GATCGGTATCATAATGCTGTGCGC -> ATCGGTATCATAATGCTGTGCGCC
TTGAAGCCTACCCGTAAGCCTGGG -> TGAAGCCTACCCGTAAGCCTGGGG
AAATTGCAGCCTCTTTTTTTCTGT -> AATTGCAGCCTCTTTTTTTCTGTA
TATCTGGGAGAATCTTCCACCAAG -> ATCTGGGAGAATCTTCCACCAAGA
GGTTAGAGTGCTGGGCTTGCCTTT -> GTTAGAGTGCTGGGCTTGCCTTTA
GCGGGCAACTACCAATAGGTTATC -> CGGGCAACTACCAATAGGTTATCT
CTGTATCACGATGTGCGCGTTGTT -> TGTATCACGATGTGCGCGTTGTTC
ACTGCCAGTGGATCCGCGCGGTAC -> CTGCCAGTGGATCCGCGCGGTACC
TTGACGCCCGTTATCAGTGCATGA -> TGACGCCCGTTATCAGTGCATGAG
GCGAGCACCGGACTGATATTGCAG -> CGAGCACCGGACTGATATTGCAGG
TCTATGATCGTCTTATTTCCAGTG -> CTATGATCGTCTTATTTCCAGTGA
GTCACACGCCCGGTGTGCTGTATT -> TCACACGCCCGGTGTGCTGTATTT
TTTTTCTGTATCACGATGTGCGCG -> TTTTCTGTATCACGATGTGCGCGT
GGTGTTCTATCTTGCCGACTTTCC -> GTGTTCTATCTTGCCGACTTTCCA
GTTATCAGTGCATGAGGGTAAAAG -> TTATCAGTGCATGAGGGTAAAAGC
CCAGTGACACTATCCCGAAATTGC -> CAGTGACACTATCCCGAAATTGCA
TGAAGCCTACCCGTAAGCCTGGGG -> GAAGCCTACCCGTAAGCCTGGGGA
TCTTTTTTTCTGTATCACGATGTG -> CTTTTTTTCTGTATCACGATGTGC
GGCCGTTGACGCCCGTTATCAGTG -> GCCGTTGACGCCCGTTATCAGTGC
GCCAGGAATGCTGGTTAGAGTGCT -> CCAGGAATGCTGGTTAGAGTGCTG
TCCACGTTAGGTATTCGCGTTGCC -> CCACGTTAGGTATTCGCGTTGCCG
GTCCTTCTAGGGCCCCAGTGCATT -> TCCTTCTAGGGCCCCAGTGCATTG
GTGCGGGCAACTACCAATAGGTTA -> TGCGGGCAACTACCAATAGGTTAT
CCGAATCTTATCTATGATCGTCTT -> CGAATCTTATCTATGATCGTCTTA
CAAACGAGACGGAGTAGCACGATA -> AAACGAGACGGAGTAGCACGATAT
ATCTCTGGGGCAATGCCTAAACCA -> TCTCTGGGGCAATGCCTAAACCAG
AGATAAAGAGGTAACAAACGAGAC -> GATAAAGAGGTAACAAACGAGACG
CTCATTCTCGGCCGTTGACGCCCG -> TCATTCTCGGCCGTTGACGCCCGT
TATCCCGAAATTGCAGCCTCTTTT -> ATCCCGAAATTGCAGCCTCTTTTT
GCCACCCATAACTCTAACCTGAGG -> CCACCCATAACTCTAACCTGAGGT
TATGCACCTCGTCACAATCGAACT -> ATGCACCTCGTCACAATCGAACTC
ATGTGCGCGTTGTTCAATATTCAG -> TGTGCGCGTTGTTCAATATTCAGC
ATCTATGATCGTCTTATTTCCAGT -> TCTATGATCGTCTTATTTCCAGTG
TTGAGGTGCCTGTAGTTCTATTCG -> TGAGGTGCCTGTAGTTCTATTCGA
GGTACGGAAATGAGACGCGATATC -> GTACGGAAATGAGACGCGATATCG
GAATGCCCCGATGTAGCCCTTCTT -> AATGCCCCGATGTAGCCCTTCTTT
TTACTAAGAACGCTGTTGGACATG -> TACTAAGAACGCTGTTGGACATGT
TCAAAAGGACTCCCGGGGGGAAGC -> CAAAAGGACTCCCGGGGGGAAGCC
AATCTTCCACCAAGAATGCCCCGA -> ATCTTCCACCAAGAATGCCCCGAT
ATGAGGGTAAAAGCGTCAAGGCTC -> TGAGGGTAAAAGCGTCAAGGCTCG
CCAGGTAAAATGCCCTTAACCCAT -> CAGGTAAAATGCCCTTAACCCATT
AAAGCGTCAAGGCTCGGTTCGTAT -> AAGCGTCAAGGCTCGGTTCGTATG
CGGGCGAGCACCGGACTGATATTG -> GGGCGAGCACCGGACTGATATTGC
GTCTTATTTCCAGTGACACTATCC -> TCTTATTTCCAGTGACACTATCCC
GGAGAGTAGAGTTAAGTTGGCATG -> GAGAGTAGAGTTAAGTTGGCATGA
GTTGGACATGTTGGTATCGATGAT -> TTGGACATGTTGGTATCGATGATT
TAATCCGGCGCCGTCGGTCACACG -> AATCCGGCGCCGTCGGTCACACGC
CGGACTGATATTGCAGGGAAGAAG -> GGACTGATATTGCAGGGAAGAAGG
GGCTGTCCTTCTAGGGCCCCAGTG -> GCTGTCCTTCTAGGGCCCCAGTGC
GCTTATCCACGGACGTGACAACTT -> CTTATCCACGGACGTGACAACTTG
ACTGATATTGCAGGGAAGAAGGCA -> CTGATATTGCAGGGAAGAAGGCAT
ATTTTACGTCGAATAGTTACGTGG -> TTTTACGTCGAATAGTTACGTGGC
TGCTGTGCGCCAAAAGATGACCGA -> GCTGTGCGCCAAAAGATGACCGAC
ATCTGGGCGACTAAGAATGACTCG -> TCTGGGCGACTAAGAATGACTCGA
TGTACTAAGTCCAGCTACGTGGCC -> GTACTAAGTCCAGCTACGTGGCCG
TAGAGGTATCGAGTGTAATGTACT -> AGAGGTATCGAGTGTAATGTACTA
GAATCTTCCACCAAGAATGCCCCG -> AATCTTCCACCAAGAATGCCCCGA
AATGCTGTGCGCCAAAAGATGACC -> ATGCTGTGCGCCAAAAGATGACCG
TCCGCGCGGTACCGTGTTGGGGAT -> CCGCGCGGTACCGTGTTGGGGATG
CATGATATTGTGCCCGGGGAACTG -> ATGATATTGTGCCCGGGGAACTGA
AATGCCCTTAACCCATTTCGCCTG -> ATGCCCTTAACCCATTTCGCCTGT
CGTCGGTCACACGCCCGGTGTGCT -> GTCGGTCACACGCCCGGTGTGCTG
TCCTCTGCATATATCATCGGGCTG -> CCTCTGCATATATCATCGGGCTGC
ACCCGCCAGGAATGCTGGTTAGAG -> CCCGCCAGGAATGCTGGTTAGAGT
TACTCATTCTCGGCCGTTGACGCC -> ACTCATTCTCGGCCGTTGACGCCC
CGTTCATGTCTAATTGCCCCAAAA -> GTTCATGTCTAATTGCCCCAAAAG
AATAGTTACGTGGCTGATACAGGT -> ATAGTTACGTGGCTGATACAGGTG
AGAAGTCTACTAAAGTATTGAGGT -> GAAGTCTACTAAAGTATTGAGGTG
CTTATCCACGGACGTGACAACTTG -> TTATCCACGGACGTGACAACTTGA
CTATCGTCATTCCGTGAATTATCC -> TATCGTCATTCCGTGAATTATCCG
TATCCACGGACGTGACAACTTGAA -> ATCCACGGACGTGACAACTTGAAG
ATCGGTATCATAATGCTGTGCGCC -> TCGGTATCATAATGCTGTGCGCCA
CTGACTGCCCGTTGTTTTCGGCTG -> TGACTGCCCGTTGTTTTCGGCTGT
TCCAGTGACACTATCCCGAAATTG -> CCAGTGACACTATCCCGAAATTGC
TATCCGTAGTTCCTACGCTCATTT -> ATCCGTAGTTCCTACGCTCATTTT
TCTAACCTGAGGTGCGGGCAACTA -> CTAACCTGAGGTGCGGGCAACTAC
ATCGAGCCCGCCTACCAGGCCTGT -> TCGAGCCCGCCTACCAGGCCTGTT
TCTTACTTACTAAGAACGCTGTTG -> CTTACTTACTAAGAACGCTGTTGG
TCGACGACTCCTCTGCATATATCA -> CGACGACTCCTCTGCATATATCAT
CCTGTAGTTCTATTCGACGACTCC -> CTGTAGTTCTATTCGACGACTCCT
TACCCATTTGAGGTGCCTGTAGTT -> ACCCATTTGAGGTGCCTGTAGTTC
GAGGTAGCTCAACTCGCTGAAAAC -> AGGTAGCTCAACTCGCTGAAAACA
CTGTTGGACATGTTGGTATCGATG -> TGTTGGACATGTTGGTATCGATGA
CTCATTTTACGTCGAATAGTTACG -> TCATTTTACGTCGAATAGTTACGT
CCAGTGGATCCGCGCGGTACCGTG -> CAGTGGATCCGCGCGGTACCGTGT
GCCAAGCGGGTGTTCTATCTTGCC -> CCAAGCGGGTGTTCTATCTTGCCG
GTTCTATCTTGCCGACTTTCCAGG -> TTCTATCTTGCCGACTTTCCAGGT
ATTTCCAGTGACACTATCCCGAAA -> TTTCCAGTGACACTATCCCGAAAT
CTCTAACCTGAGGTGCGGGCAACT -> TCTAACCTGAGGTGCGGGCAACTA
TGATCGGTATCATAATGCTGTGCG -> GATCGGTATCATAATGCTGTGCGC
TATGTTGCATACGAACCCGCCAGG -> ATGTTGCATACGAACCCGCCAGGA
TGCCCTTAACCCATTTCGCCTGTG -> GCCCTTAACCCATTTCGCCTGTGA
ACGTCGAATAGTTACGTGGCTGAT -> CGTCGAATAGTTACGTGGCTGATA
GGGCGTCGAGAGCATCCTCTAGGT -> GGCGTCGAGAGCATCCTCTAGGTA
CTGTAGTTCTATTCGACGACTCCT -> TGTAGTTCTATTCGACGACTCCTC
CTGGGCTTGCCTTTAGTGATTCAT -> TGGGCTTGCCTTTAGTGATTCATT
AGGGAAGAAGGCATGATAATCTGG -> GGGAAGAAGGCATGATAATCTGGG
GAATTGTCTGTGCCCACTGCCAGT -> AATTGTCTGTGCCCACTGCCAGTG
AGTCTACTAAAGTATTGAGGTGGC -> GTCTACTAAAGTATTGAGGTGGCT
TGGTATTTACGCCGCATACTAGTC -> GGTATTTACGCCGCATACTAGTCG
GACTGATATTGCAGGGAAGAAGGC -> ACTGATATTGCAGGGAAGAAGGCA
TTCTGTCTATTACAAGCGTGCTTA -> TCTGTCTATTACAAGCGTGCTTAT
GGCCTGTTGATTGTAGACGGTTCT -> GCCTGTTGATTGTAGACGGTTCTG
TACTAAGTCCAGCTACGTGGCCGG -> ACTAAGTCCAGCTACGTGGCCGGT
TGACTCGACTCGTTCTGTCTATTA -> GACTCGACTCGTTCTGTCTATTAC
CCTGGGGATTGATAAGCCGCGGAG -> CTGGGGATTGATAAGCCGCGGAGA
CGGTACGGAAATGAGACGCGATAT -> GGTACGGAAATGAGACGCGATATC
AACCAGGTGCGCATAATCCGGCGC -> ACCAGGTGCGCATAATCCGGCGCC
TTAAAGAAGACATGATATTGTGCC -> TAAAGAAGACATGATATTGTGCCC
AAAACATATTACTCATTCTCGGCC -> AAACATATTACTCATTCTCGGCCG
TCTATCGTCATTCCGTGAATTATC -> CTATCGTCATTCCGTGAATTATCC
TTCGGCTGTCCTTCTAGGGCCCCA -> TCGGCTGTCCTTCTAGGGCCCCAG
CTTCAAAAGGACTCCCGGGGGGAA -> TTCAAAAGGACTCCCGGGGGGAAG
CTAAGAACGCTGTTGGACATGTTG -> TAAGAACGCTGTTGGACATGTTGG
CATGTTGGTATCGATGATTTGGTA -> ATGTTGGTATCGATGATTTGGTAT
CGTCGAATAGTTACGTGGCTGATA -> GTCGAATAGTTACGTGGCTGATAC
CGACGGAGAAGTCTACTAAAGTAT -> GACGGAGAAGTCTACTAAAGTATT
TCTATTCGACGACTCCTCTGCATA -> CTATTCGACGACTCCTCTGCATAT
TTCCTACGCTCATTTTACGTCGAA -> TCCTACGCTCATTTTACGTCGAAT
GTGGCGCTCTGGGCGTCGAGAGCA -> TGGCGCTCTGGGCGTCGAGAGCAT
TCTGCTTATTACAGTGGCGCTCTG -> CTGCTTATTACAGTGGCGCTCTGG
GATTTGGTATTTACGCCGCATACT -> ATTTGGTATTTACGCCGCATACTA
ATACTAGTCGTGATGCGGTACGGA -> TACTAGTCGTGATGCGGTACGGAA
CAGGTAAAATGCCCTTAACCCATT -> AGGTAAAATGCCCTTAACCCATTT
TGAATTATCCGTAGTTCCTACGCT -> GAATTATCCGTAGTTCCTACGCTC
GTCATTCCGTGAATTATCCGTAGT -> TCATTCCGTGAATTATCCGTAGTT
GAAGCATAAGGAAGCCACCAGCCT -> AAGCATAAGGAAGCCACCAGCCTG
TGACTTCAAAAGGACTCCCGGGGG -> GACTTCAAAAGGACTCCCGGGGGG
GTTGCATACGAACCCGCCAGGAAT -> TTGCATACGAACCCGCCAGGAATG
GATTGCCGATATGTTGCATACGAA -> ATTGCCGATATGTTGCATACGAAC
AACTCGCTGAAAACATATTACTCA -> ACTCGCTGAAAACATATTACTCAT
ACGGTGTCGGATACCCATCTCTGG -> CGGTGTCGGATACCCATCTCTGGG
CGTAGTTCCTACGCTCATTTTACG -> GTAGTTCCTACGCTCATTTTACGT
AAGCAGGAGGCGGGCCGGAGGAGG -> AGCAGGAGGCGGGCCGGAGGAGGC
TGAGGTGCGGGCAACTACCAATAG -> GAGGTGCGGGCAACTACCAATAGG
TTACGTCGAATAGTTACGTGGCTG -> TACGTCGAATAGTTACGTGGCTGA
GCCTACCCGTAAGCCTGGGGATTG -> CCTACCCGTAAGCCTGGGGATTGA
CGTTGACGCCCGTTATCAGTGCAT -> GTTGACGCCCGTTATCAGTGCATG
TTGATGCACTGCTCGTTCATGTCT -> TGATGCACTGCTCGTTCATGTCTA
GGTAAACGGTGTCGGATACCCATC -> GTAAACGGTGTCGGATACCCATCT
ACGCTGTTGGACATGTTGGTATCG -> CGCTGTTGGACATGTTGGTATCGA
ATCTTCCACCAAGAATGCCCCGAT -> TCTTCCACCAAGAATGCCCCGATG
TGTCGGATACCCATCTCTGGGGCA -> GTCGGATACCCATCTCTGGGGCAA
ATTGTGCGGGCGAGCACCGGACTG -> TTGTGCGGGCGAGCACCGGACTGA
TCGAGCCCGCCTACCAGGCCTGTT -> CGAGCCCGCCTACCAGGCCTGTTG
GATATCGAGCCCGCCTACCAGGCC -> ATATCGAGCCCGCCTACCAGGCCT
CGAATAGTTACGTGGCTGATACAG -> GAATAGTTACGTGGCTGATACAGG
CCCAAAAGATAGAGGTATCGAGTG -> CCAAAAGATAGAGGTATCGAGTGT
GGGCTGCCATCGAAGCAGGAGGCG -> GGCTGCCATCGAAGCAGGAGGCGG
GTGTCGGATACCCATCTCTGGGGC -> TGTCGGATACCCATCTCTGGGGCA
CTCTGCTTATTACAGTGGCGCTCT -> TCTGCTTATTACAGTGGCGCTCTG
CTGGGCGTCGAGAGCATCCTCTAG -> TGGGCGTCGAGAGCATCCTCTAGG
TGTTTTCGGCTGTCCTTCTAGGGC -> GTTTTCGGCTGTCCTTCTAGGGCC
CCGCGGAGAGTAGAGTTAAGTTGG -> CGCGGAGAGTAGAGTTAAGTTGGC
AGCATAAGGAAGCCACCAGCCTGA -> GCATAAGGAAGCCACCAGCCTGAC
ATTCAAGGCAGATTCCAGCACCTC -> TTCAAGGCAGATTCCAGCACCTCA
ATCCGTAGTTCCTACGCTCATTTT -> TCCGTAGTTCCTACGCTCATTTTA
GCCAGTGGATCCGCGCGGTACCGT -> CCAGTGGATCCGCGCGGTACCGTG
GGAACTGAGATAAAGAGGTAACAA -> GAACTGAGATAAAGAGGTAACAAA
TTACGTGGCTGATACAGGTGCCAA -> TACGTGGCTGATACAGGTGCCAAC
ACTCGGGTGTGTTTGCGGGGCTAA -> CTCGGGTGTGTTTGCGGGGCTAAG
CGTTAGGTATTCGCGTTGCCGATT -> GTTAGGTATTCGCGTTGCCGATTC
TGAAGTGTGCGTGACTTCAAAAGG -> GAAGTGTGCGTGACTTCAAAAGGA
TTTCGCCTGTGAGGTAGCTCAACT -> TTCGCCTGTGAGGTAGCTCAACTC
ATGCAATCATGTCTTACTTACTAA -> TGCAATCATGTCTTACTTACTAAG
ACGTGGCTGATACAGGTGCCAACT -> CGTGGCTGATACAGGTGCCAACTC
CCGATATGTTGCATACGAACCCGC -> CGATATGTTGCATACGAACCCGCC
CCACGTTAGGTATTCGCGTTGCCG -> CACGTTAGGTATTCGCGTTGCCGA
GACGCGATATCGAGCCCGCCTACC -> ACGCGATATCGAGCCCGCCTACCA
TATTGTTGAAGCCTACCCGTAAGC -> ATTGTTGAAGCCTACCCGTAAGCC
TTTCTGTATCACGATGTGCGCGTT -> TTCTGTATCACGATGTGCGCGTTG
TTCTTACCCATTTGAGGTGCCTGT -> TCTTACCCATTTGAGGTGCCTGTA
AGAGGTAACAAACGAGACGGAGTA -> GAGGTAACAAACGAGACGGAGTAG
AAGTTGGCATGAAGTTGATCGGTA -> AGTTGGCATGAAGTTGATCGGTAT
CGCTCATTTTACGTCGAATAGTTA -> GCTCATTTTACGTCGAATAGTTAC
CGTGATGCGGTACGGAAATGAGAC -> GTGATGCGGTACGGAAATGAGACG
TAGGGCCCCAGTGCATTGACATAG -> AGGGCCCCAGTGCATTGACATAGT
ACTTACTAAGAACGCTGTTGGACA -> CTTACTAAGAACGCTGTTGGACAT
CGCATAATCCGGCGCCGTCGGTCA -> GCATAATCCGGCGCCGTCGGTCAC
ATGTACTAAGTCCAGCTACGTGGC -> TGTACTAAGTCCAGCTACGTGGCC
TGGATCCGCGCGGTACCGTGTTGG -> GGATCCGCGCGGTACCGTGTTGGG
ACTCGTTCTGTCTATTACAAGCGT -> CTCGTTCTGTCTATTACAAGCGTG
TAATGTACTAAGTCCAGCTACGTG -> AATGTACTAAGTCCAGCTACGTGG
GGGGCTAAGGCTCGTTAACAATCT -> GGGCTAAGGCTCGTTAACAATCTT
AGTAGCACGATATGCACCTCGTCA -> GTAGCACGATATGCACCTCGTCAC
TATTTGATGCACTGCTCGTTCATG -> ATTTGATGCACTGCTCGTTCATGT
ACCGGACTGATATTGCAGGGAAGA -> CCGGACTGATATTGCAGGGAAGAA
TTTCCAGTGACACTATCCCGAAAT -> TTCCAGTGACACTATCCCGAAATT
ATGAAGTTGATCGGTATCATAATG -> TGAAGTTGATCGGTATCATAATGC
TCGCTGAAAACATATTACTCATTC -> CGCTGAAAACATATTACTCATTCT
GGAAATGAGACGCGATATCGAGCC -> GAAATGAGACGCGATATCGAGCCC
CGTTATCAGTGCATGAGGGTAAAA -> GTTATCAGTGCATGAGGGTAAAAG
CGTTGCCGATTCAAGGCAGATTCC -> GTTGCCGATTCAAGGCAGATTCCA
GCGTCAAGGCTCGGTTCGTATGCC -> CGTCAAGGCTCGGTTCGTATGCCT
CCCCAGTGCATTGACATAGTCACG -> CCCAGTGCATTGACATAGTCACGC
GTTTGCGGGGCTAAGGCTCGTTAA -> TTTGCGGGGCTAAGGCTCGTTAAC
TGACACTATCCCGAAATTGCAGCC -> GACACTATCCCGAAATTGCAGCCT
GATTCATTAAAGAAGACATGATAT -> ATTCATTAAAGAAGACATGATATT
GTCAATTGTGCGGGCGAGCACCGG -> TCAATTGTGCGGGCGAGCACCGGA
TTCAGCTCGAATTGTCTGTGCCCA -> TCAGCTCGAATTGTCTGTGCCCAC
TGGCTTCCCCCCTTCTTACCCATT -> GGCTTCCCCCCTTCTTACCCATTT
AAGCCTGGGGATTGATAAGCCGCG -> AGCCTGGGGATTGATAAGCCGCGG
GACATGATATTGTGCCCGGGGAAC -> ACATGATATTGTGCCCGGGGAACT
TTCCAGGTAAAATGCCCTTAACCC -> TCCAGGTAAAATGCCCTTAACCCA
ATATTGTGCCCGGGGAACTGAGAT -> TATTGTGCCCGGGGAACTGAGATA
TATATCATCGGGCTGCCATCGAAG -> ATATCATCGGGCTGCCATCGAAGC
TATTGCAGGGAAGAAGGCATGATA -> ATTGCAGGGAAGAAGGCATGATAA
AATCTTTGCGCCCGAATCTTATCT -> ATCTTTGCGCCCGAATCTTATCTA
GCCGTTGACGCCCGTTATCAGTGC -> CCGTTGACGCCCGTTATCAGTGCA
GACACTATCCCGAAATTGCAGCCT -> ACACTATCCCGAAATTGCAGCCTC
CTGTCTATTACAAGCGTGCTTATC -> TGTCTATTACAAGCGTGCTTATCC
AGGCCTGTTGATTGTAGACGGTTC -> GGCCTGTTGATTGTAGACGGTTCT
CCGTTGACGCCCGTTATCAGTGCA -> CGTTGACGCCCGTTATCAGTGCAT
CCTCGTCACAATCGAACTCTCTAT -> CTCGTCACAATCGAACTCTCTATC
AACATATTACTCATTCTCGGCCGT -> ACATATTACTCATTCTCGGCCGTT
CTGAAAACATATTACTCATTCTCG -> TGAAAACATATTACTCATTCTCGG
TATTAAGCTATTGTTGAAGCCTAC -> ATTAAGCTATTGTTGAAGCCTACC
AGGTAACAAACGAGACGGAGTAGC -> GGTAACAAACGAGACGGAGTAGCA
GCTATTGTTGAAGCCTACCCGTAA -> CTATTGTTGAAGCCTACCCGTAAG
CTTCTTTTGTTCCCGCTCTGCTTA -> TTCTTTTGTTCCCGCTCTGCTTAT
GGGCTTGCCTTTAGTGATTCATTA -> GGCTTGCCTTTAGTGATTCATTAA
GGATTGATAAGCCGCGGAGAGTAG -> GATTGATAAGCCGCGGAGAGTAGA
GAGACGGAGTAGCACGATATGCAC -> AGACGGAGTAGCACGATATGCACC
TCGTGATGCGGTACGGAAATGAGA -> CGTGATGCGGTACGGAAATGAGAC
TTGATCGGTATCATAATGCTGTGC -> TGATCGGTATCATAATGCTGTGCG
CTTACTAAGAACGCTGTTGGACAT -> TTACTAAGAACGCTGTTGGACATG
TGTTCTATCTTGCCGACTTTCCAG -> GTTCTATCTTGCCGACTTTCCAGG
GCCTCTTTTTTTCTGTATCACGAT -> CCTCTTTTTTTCTGTATCACGATG
TGTTGATTGTAGACGGTTCTGGTG -> GTTGATTGTAGACGGTTCTGGTGG
GTACGGAAATGAGACGCGATATCG -> TACGGAAATGAGACGCGATATCGA
TGTCCACGTTAGGTATTCGCGTTG -> GTCCACGTTAGGTATTCGCGTTGC
AATTGCCCCAAAAGATAGAGGTAT -> ATTGCCCCAAAAGATAGAGGTATC
TCACAATCGAACTCTCTATCGTCA -> CACAATCGAACTCTCTATCGTCAT
GGACTGATATTGCAGGGAAGAAGG -> GACTGATATTGCAGGGAAGAAGGC
ATACGAACCCGCCAGGAATGCTGG -> TACGAACCCGCCAGGAATGCTGGT
GAATTATCCGTAGTTCCTACGCTC -> AATTATCCGTAGTTCCTACGCTCA
TTTGCGGGGCTAAGGCTCGTTAAC -> TTGCGGGGCTAAGGCTCGTTAACA
TAAGGAAGCCACCAGCCTGACTGC -> AAGGAAGCCACCAGCCTGACTGCC
CGTATTAAGCTATTGTTGAAGCCT -> GTATTAAGCTATTGTTGAAGCCTA
AAAGTATTGAGGTGGCTTCCCCCC -> AAGTATTGAGGTGGCTTCCCCCCT
TTCTATCTTGCCGACTTTCCAGGT -> TCTATCTTGCCGACTTTCCAGGTA
AGATGCAATCATGTCTTACTTACT -> GATGCAATCATGTCTTACTTACTA
AAGAAGGCATGATAATCTGGGCGA -> AGAAGGCATGATAATCTGGGCGAC
CCGTAGTTCCTACGCTCATTTTAC -> CGTAGTTCCTACGCTCATTTTACG
CTCTATCGTCATTCCGTGAATTAT -> TCTATCGTCATTCCGTGAATTATC
CCCGGGGGGAAGCCAGCCACCCAT -> CCGGGGGGAAGCCAGCCACCCATA
GGGTGTGTTTGCGGGGCTAAGGCT -> GGTGTGTTTGCGGGGCTAAGGCTC
CGCGTTGTTCAATATTCAGCTCGA -> GCGTTGTTCAATATTCAGCTCGAA
ACGGAAATGAGACGCGATATCGAG -> CGGAAATGAGACGCGATATCGAGC
AGTGCATTGACATAGTCACGCCAA -> GTGCATTGACATAGTCACGCCAAG
CTCGTTCATGTCTAATTGCCCCAA -> TCGTTCATGTCTAATTGCCCCAAA
TATCACGATGTGCGCGTTGTTCAA -> ATCACGATGTGCGCGTTGTTCAAT
AGGAGGCGGGCCGGAGGAGGCAGA -> GGAGGCGGGCCGGAGGAGGCAGAG
CGACTAAGAATGACTCGACTCGTT -> GACTAAGAATGACTCGACTCGTTC
TCGAACTCTCTATCGTCATTCCGT -> CGAACTCTCTATCGTCATTCCGTG
CGGAGAGTAGAGTTAAGTTGGCAT -> GGAGAGTAGAGTTAAGTTGGCATG
ATGACTCGACTCGTTCTGTCTATT -> TGACTCGACTCGTTCTGTCTATTA
CGGATACCCATCTCTGGGGCAATG -> GGATACCCATCTCTGGGGCAATGC
ACGCCCGGTGTGCTGTATTTGATG -> CGCCCGGTGTGCTGTATTTGATGC
ATTCAGCTCGAATTGTCTGTGCCC -> TTCAGCTCGAATTGTCTGTGCCCA
TACGTGGCTGATACAGGTGCCAAC -> ACGTGGCTGATACAGGTGCCAACT
GATAAGCCGCGGAGAGTAGAGTTA -> ATAAGCCGCGGAGAGTAGAGTTAA
CACGATGTGCGCGTTGTTCAATAT -> ACGATGTGCGCGTTGTTCAATATT
GACGGAGTAGCACGATATGCACCT -> ACGGAGTAGCACGATATGCACCTC
CAAGGCAGATTCCAGCACCTCAAT -> AAGGCAGATTCCAGCACCTCAATG
CCGTGAATTATCCGTAGTTCCTAC -> CGTGAATTATCCGTAGTTCCTACG
GCCAGCCACCCATAACTCTAACCT -> CCAGCCACCCATAACTCTAACCTG
ATTGTGCCCGGGGAACTGAGATAA -> TTGTGCCCGGGGAACTGAGATAAA
CCAGCACCTCAATGAAGTGTGCGT -> CAGCACCTCAATGAAGTGTGCGTG
GACTCCCGGGGGGAAGCCAGCCAC -> ACTCCCGGGGGGAAGCCAGCCACC
AAATGCCCTTAACCCATTTCGCCT -> AATGCCCTTAACCCATTTCGCCTG
AGGCTCGGTTCGTATGCCTCTTGC -> GGCTCGGTTCGTATGCCTCTTGCG
AAAAGATGACCGACGGAGAAGTCT -> AAAGATGACCGACGGAGAAGTCTA
GAAGAAGGCATGATAATCTGGGCG -> AAGAAGGCATGATAATCTGGGCGA
CTTTTTTTCTGTATCACGATGTGC -> TTTTTTTCTGTATCACGATGTGCG
TGTGCCCACTGCCAGTGGATCCGC -> GTGCCCACTGCCAGTGGATCCGCG
GATAAAGAGGTAACAAACGAGACG -> ATAAAGAGGTAACAAACGAGACGG
GTTCTGTCTATTACAAGCGTGCTT -> TTCTGTCTATTACAAGCGTGCTTA
AAGATAGAGGTATCGAGTGTAATG -> AGATAGAGGTATCGAGTGTAATGT
TGTGTTTGCGGGGCTAAGGCTCGT -> GTGTTTGCGGGGCTAAGGCTCGTT
AAGCCTACCCGTAAGCCTGGGGAT -> AGCCTACCCGTAAGCCTGGGGATT
GCATACTAGTCGTGATGCGGTACG -> CATACTAGTCGTGATGCGGTACGG
GCGGGCCGGAGGAGGCAGAGACCA -> CGGGCCGGAGGAGGCAGAGACCAG
GAAGAGGTCAGTGAAGATGCAATC -> AAGAGGTCAGTGAAGATGCAATCA
ACTCTCTATCGTCATTCCGTGAAT -> CTCTCTATCGTCATTCCGTGAATT
CAAGCGTGCTTATCCACGGACGTG -> AAGCGTGCTTATCCACGGACGTGA
GGCTAAGGCTCGTTAACAATCTTT -> GCTAAGGCTCGTTAACAATCTTTG
AGTGAAGATGCAATCATGTCTTAC -> GTGAAGATGCAATCATGTCTTACT
TGGACATGTTGGTATCGATGATTT -> GGACATGTTGGTATCGATGATTTG
TGATTTGGTATTTACGCCGCATAC -> GATTTGGTATTTACGCCGCATACT
AGCTCAACTCGCTGAAAACATATT -> GCTCAACTCGCTGAAAACATATTA
ACCAATAGGTTATCTGGGAGAATC -> CCAATAGGTTATCTGGGAGAATCT
CTGAGATAAAGAGGTAACAAACGA -> TGAGATAAAGAGGTAACAAACGAG
ACGGTTCTGGTGGATGGAAGCATA -> CGGTTCTGGTGGATGGAAGCATAA
GGCTGATACAGGTGCCAACTCGGG -> GCTGATACAGGTGCCAACTCGGGT
GGGTGTTCTATCTTGCCGACTTTC -> GGTGTTCTATCTTGCCGACTTTCC
CCAGGTGCGCATAATCCGGCGCCG -> CAGGTGCGCATAATCCGGCGCCGT
CAGTGAAGATGCAATCATGTCTTA -> AGTGAAGATGCAATCATGTCTTAC
CCGTCGGTCACACGCCCGGTGTGC -> CGTCGGTCACACGCCCGGTGTGCT
TGAGGTAGCTCAACTCGCTGAAAA -> GAGGTAGCTCAACTCGCTGAAAAC
GCTCGTTCATGTCTAATTGCCCCA -> CTCGTTCATGTCTAATTGCCCCAA
ATTTACGCCGCATACTAGTCGTGA -> TTTACGCCGCATACTAGTCGTGAT
AGAGCATCCTCTAGGTAAACGGTG -> GAGCATCCTCTAGGTAAACGGTGT
CAATCATGTCTTACTTACTAAGAA -> AATCATGTCTTACTTACTAAGAAC
CCTGACTGCCCGTTGTTTTCGGCT -> CTGACTGCCCGTTGTTTTCGGCTG
TTCATGTCTAATTGCCCCAAAAGA -> TCATGTCTAATTGCCCCAAAAGAT
GAACTCTCTATCGTCATTCCGTGA -> AACTCTCTATCGTCATTCCGTGAA
GATGATTTGGTATTTACGCCGCAT -> ATGATTTGGTATTTACGCCGCATA
CCTCAATGAAGTGTGCGTGACTTC -> CTCAATGAAGTGTGCGTGACTTCA
AACGAGACGGAGTAGCACGATATG -> ACGAGACGGAGTAGCACGATATGC
AGTGGATCCGCGCGGTACCGTGTT -> GTGGATCCGCGCGGTACCGTGTTG
AGGTGCCTGTAGTTCTATTCGACG -> GGTGCCTGTAGTTCTATTCGACGA
TAGGTAAACGGTGTCGGATACCCA -> AGGTAAACGGTGTCGGATACCCAT
CAAAAGATGACCGACGGAGAAGTC -> AAAAGATGACCGACGGAGAAGTCT